59,59,59,59,59,60,61,62,26,59,59,59,59,59,59,59,26,26,26,26,26,26,26,26,27,28,29,59,59,59,
59,59,59,59,59,26,26,26,26,26,26,26,26,26,39,26,59,59,59,59,59,59,59,59,26,39,39,26,27,28,
26,26,26,26,26,26,26,26,26,26,26,26,26,26,26,26,26,26,26,26,26,26,26,26,26,39,39,26,26,27,
59,59,59,39,39,26,26,26,26,26,26,26,26,26,26,39,26,26,26,26,26,26,27,28,29,39,39,28,29,29,
26,26,26,26,39,59,59,59,59,59,44,45,59,59,39,59,59,59,59,59,44,45,45,45,26,26,26,26,27,28,
59,59,39,59,759,760,761,762,763,764,765,45,59,26,26,26,26,44,45,45,45,45,59,59,59,59,59,59,26,26,
29,29,29,62,792,793,794,795,796,797,798,26,26,59,59,59,59,44,45,59,59,26,27,28,29,29,29,26,27,28,
62,62,62,29,825,826,827,828,829,830,831,29,29,29,29,29,29,29,29,29,29,29,29,26,27,28,29,29,29,29,
59,60,61,62,858,859,860,861,862,863,864,62,62,62,62,62,62,62,62,26,27,39,29,29,29,29,29,62,62,62,
29,29,29,29,891,892,893,894,895,896,897,45,28,29,29,29,29,29,29,169,29,26,39,26,26,26,26,26,26,26,
26,26,26,26,924,925,926,927,928,929,930,45,26,26,26,26,26,26,26,26,26,1056,1057,1058,1059,1060,59,59,59,59,
26,26,26,26,957,958,959,960,961,962,963,45,59,59,59,59,59,39,39,59,59,1089,1090,1091,1092,1093,26,26,26,26,
26,26,26,26,990,991,992,993,994,995,996,44,45,44,44,44,44,44,45,26,26,1122,1123,1124,1125,1126,26,26,26,26,
59,59,59,59,60,61,39,39,39,39,44,44,45,44,44,44,44,44,45,44,44,1155,1156,1157,1158,1159,59,59,59,59,
26,26,26,26,26,26,26,39,44,44,44,44,44,44,44,45,44,45,45,44,45,1188,1189,1190,1191,1192,26,26,26,26,
59,26,26,26,26,26,26,26,44,45,26,26,44,44,44,44,44,44,44,44,45,1221,1222,1223,1224,1225,59,59,59,59,
26,59,59,59,59,59,59,59,59,59,59,59,26,44,44,45,45,44,45,45,26,1254,1255,1256,1257,1258,45,26,26,26,
26,26,26,26,1056,1057,1058,1059,1060,26,26,26,59,59,44,44,45,44,45,39,59,1287,1288,1289,1290,1291,45,59,59,59,
59,59,59,59,1089,1090,1091,1092,1093,44,45,59,60,61,62,44,45,44,44,44,44,44,45,26,26,26,27,28,29,27,
26,26,26,26,1122,1123,1124,1125,1126,45,26,26,26,26,26,44,45,44,45,44,44,44,45,59,26,26,26,26,26,26,
59,59,59,59,1155,1156,1157,1158,1159,59,59,59,59,44,45,45,45,44,44,44,45,44,45,26,59,59,59,26,27,28,
61,62,29,29,1188,1189,1190,1191,1192,45,26,26,44,45,45,59,59,59,44,45,44,45,27,28,29,29,29,29,29,29,
26,26,26,44,1221,1222,1223,1224,1225,45,59,44,45,45,28,26,26,26,44,44,45,45,45,45,45,26,26,26,26,26,
26,26,26,44,1254,1255,1256,1257,1258,45,26,26,26,26,26,26,26,26,44,45,45,45,45,28,29,59,59,59,59,26,
26,26,26,26,1287,1288,1289,1290,1291,44,45,59,59,59,59,59,59,59,59,59,59,26,26,26,26,26,26,26,26,26,
59,59,59,44,45,45,45,44,45,44,44,45,26,26,26,26,26,26,26,26,26,59,44,44,45,59,59,59,59,59,
62,26,44,45,45,26,26,44,45,59,59,59,59,59,26,26,26,26,26,26,26,44,44,45,26,26,26,26,26,26,
62,59,44,45,59,26,44,45,45,26,26,26,26,26,59,59,59,59,59,59,26,44,45,26,26,26,26,26,59,59,
59,26,26,26,26,59,59,59,59,59,59,59,59,59,60,26,26,26,26,26,59,59,59,59,59,59,59,59,59,60,
61,59,59,59,59,59,60,61,62,62,62,62,62,62,26,59,59,59,59,59,59,60,61,62,62,62,62,62,62,62,
