586,587,588,589,588,587,588,587,588,587,588,587,588,587,588,587,587,588,587,588,587,588,587,588,587,588,586,587,588,589,
619,620,621,622,654,653,654,653,654,653,654,653,654,653,653,654,653,654,653,654,653,654,653,654,653,654,619,620,621,622,
652,653,654,655,687,686,687,686,687,686,687,686,687,686,686,687,686,687,686,687,686,687,686,687,686,687,652,653,654,655,
685,686,687,688,720,719,720,719,720,719,720,719,720,719,719,720,719,720,719,720,719,720,719,720,719,720,685,686,687,688,
619,622,720,721,753,752,753,752,753,752,753,752,753,752,752,753,752,753,752,753,752,753,752,753,752,753,718,719,619,622,
619,622,753,754,786,785,786,785,786,785,786,785,786,785,785,786,785,786,785,786,785,786,785,786,785,786,751,752,619,622,
619,622,786,787,361,38,39,361,361,361,361,361,361,361,118,118,118,361,361,361,361,361,361,361,361,361,784,785,619,622,
619,622,361,361,44,38,39,60,361,361,44,361,361,44,118,118,118,60,361,361,44,361,361,44,361,361,361,361,619,622,
619,622,361,361,361,38,39,361,361,361,361,361,361,361,118,118,118,361,361,361,361,361,361,361,361,361,361,361,619,622,
652,655,361,361,361,361,361,361,361,361,361,361,361,361,118,118,118,361,361,361,361,361,361,361,361,361,361,361,619,622,
685,688,361,361,44,361,361,44,361,361,44,361,361,44,118,118,118,44,361,361,44,361,361,361,361,361,39,361,619,622,
718,721,361,361,361,361,361,361,361,361,361,361,361,361,118,118,118,361,361,361,361,361,361,361,361,361,361,361,619,622,
751,754,361,361,361,361,361,361,361,361,361,361,361,361,118,118,118,361,361,361,361,361,361,361,361,361,361,361,619,622,
784,787,361,361,60,361,361,44,361,361,44,361,361,44,118,118,118,44,361,361,60,361,361,361,361,361,39,361,619,622,
118,118,118,118,118,118,118,118,118,118,118,118,118,118,118,118,118,361,361,361,361,361,361,361,361,361,361,361,619,622,
118,118,118,118,118,118,118,118,118,118,118,118,118,118,118,118,118,361,361,361,361,361,361,361,361,361,361,361,619,622,
118,118,118,118,118,118,118,118,118,118,118,118,118,118,118,118,118,361,361,361,361,361,361,361,361,361,361,361,619,622,
586,589,361,361,361,361,361,361,361,361,361,361,361,361,118,118,118,361,361,361,361,118,118,361,361,361,361,361,619,622,
619,622,361,361,361,361,361,361,361,361,361,361,361,361,118,118,118,361,361,361,118,118,118,118,361,361,361,361,619,622,
619,622,361,361,361,361,361,361,361,361,361,361,361,361,118,118,118,361,361,361,118,118,118,118,361,361,361,361,619,622,
619,622,361,361,361,361,361,361,361,361,361,361,361,361,118,118,118,361,361,361,361,118,118,361,361,361,361,361,619,622,
619,622,361,361,361,361,361,361,361,361,361,361,361,361,118,118,118,361,361,361,361,361,361,361,361,361,361,361,619,622,
619,622,361,361,361,361,361,361,361,361,361,361,361,361,118,118,118,361,361,361,361,361,361,361,361,361,361,361,619,622,
586,587,588,589,361,361,361,361,361,361,361,361,361,361,118,118,118,361,361,361,361,361,361,361,361,361,586,587,588,589,
619,620,621,622,588,587,588,587,588,587,588,587,588,589,118,118,118,586,587,588,587,588,587,588,587,588,619,620,621,622,
652,653,654,655,654,653,654,653,654,653,654,653,654,655,118,118,118,652,653,654,653,654,653,654,653,654,652,653,654,655,
685,686,687,688,687,686,687,686,687,686,687,686,687,688,118,118,118,685,686,687,686,687,686,687,686,687,685,686,687,688,
718,719,720,721,720,719,720,719,720,719,720,719,720,721,118,118,118,718,719,720,719,720,719,720,719,720,718,719,720,721,
751,752,753,754,753,752,753,752,753,752,753,752,753,754,118,118,118,751,752,753,752,753,752,753,752,753,751,752,753,754,
784,785,786,787,786,785,786,785,786,785,786,785,786,787,118,118,118,784,785,786,785,786,785,786,785,786,784,785,786,787,
