9,9,9,10,9,9,10,9,9,9,9,9,9,9,10,9,10,10,10,10,10,10,10,10,9,10,10,10,10,10,
9,9,9,9,9,9,9,9,10,10,10,9,10,9,10,10,10,9,10,9,10,10,10,9,9,10,9,10,9,10,
9,10,9,10,9,9,10,9,9,9,10,10,10,10,9,10,10,10,9,9,10,9,9,9,10,9,10,10,10,9,
18,17,18,17,18,17,18,17,22,9,9,9,9,9,10,9,9,10,10,9,10,10,10,10,9,9,10,10,9,9,
0,1,2,0,0,0,0,0,16,17,18,17,22,9,23,18,22,10,9,9,10,10,10,9,9,10,9,9,9,10,
0,1,2,3,0,1,2,2,3,3,3,3,16,17,19,4,20,10,9,9,10,9,10,10,9,9,9,9,10,9,
26,27,28,26,26,26,26,26,38,38,39,0,1,2,3,20,10,10,23,22,9,9,9,10,9,9,9,10,10,9,
26,27,28,59,59,59,59,26,27,26,38,39,2,4,20,9,10,23,19,8,9,9,10,9,10,9,10,9,10,9,
26,27,28,59,60,61,28,59,38,39,38,39,4,20,9,10,23,19,2,16,22,9,9,10,10,9,10,9,10,9,
26,27,28,59,60,61,61,28,38,39,39,4,20,9,10,10,11,1,1,2,16,22,9,10,10,9,9,10,9,10,
26,27,28,61,59,60,61,38,39,39,2,12,9,10,10,38,38,39,2,2,3,16,22,9,10,9,9,9,9,10,
26,26,27,28,28,59,60,38,39,39,2,8,9,10,38,39,38,38,38,39,2,3,12,9,10,9,9,9,10,9,
26,26,27,28,61,59,60,38,38,39,38,39,38,39,38,38,38,39,38,38,39,2,16,17,22,9,9,10,9,9,
26,26,27,28,61,59,59,60,38,38,39,39,38,38,39,39,38,39,38,38,39,2,2,4,20,9,10,9,9,9,
26,26,27,28,61,59,60,61,61,38,38,39,38,39,38,39,38,39,38,38,39,2,4,20,13,10,10,9,9,9,
26,26,27,28,60,26,59,60,61,61,38,38,39,38,38,39,38,38,38,38,39,39,20,9,10,10,9,9,9,9,
26,26,27,28,60,26,26,26,26,27,38,38,38,38,39,39,39,38,39,39,39,39,9,10,10,14,9,9,9,10,
26,27,28,61,60,59,59,59,26,26,26,38,38,38,38,39,39,39,39,38,39,39,9,10,23,22,9,9,10,9,
26,26,27,28,26,26,27,28,59,59,59,59,59,38,38,38,39,39,38,39,39,9,10,10,11,8,9,9,9,9,
26,26,27,28,26,27,28,28,59,60,61,26,27,28,28,38,38,39,39,39,9,10,10,23,19,16,22,9,9,10,
26,26,27,26,26,27,28,26,27,26,27,26,27,28,61,61,38,38,39,39,9,10,23,19,3,3,16,22,9,10,
26,27,28,26,26,27,26,27,28,26,26,27,28,61,59,60,59,38,38,39,38,38,38,39,2,3,4,20,9,10,
26,27,28,26,27,26,27,28,28,26,26,27,28,60,59,60,59,59,38,38,39,38,38,39,2,2,12,9,9,10,
26,27,28,26,27,26,27,28,26,27,26,27,28,60,59,26,59,60,61,38,38,38,38,39,2,3,12,9,9,10,
26,27,28,26,27,26,27,28,26,27,26,27,28,60,59,26,59,60,61,59,60,38,38,39,2,4,20,9,9,10,
26,27,28,26,26,27,28,28,26,27,26,27,28,26,59,26,59,60,61,61,26,38,39,2,4,20,9,9,9,10,
26,27,28,26,26,27,28,61,26,27,26,27,28,59,59,26,27,59,60,61,26,27,28,2,12,9,9,9,9,10,
26,27,26,26,26,26,27,28,26,27,26,26,27,28,60,26,26,59,60,26,27,28,61,4,20,9,9,9,9,10,
26,26,59,26,59,26,26,26,26,27,59,26,26,27,28,59,26,59,59,59,60,61,2,12,9,9,10,9,9,10,
59,59,60,26,26,59,59,59,26,26,26,59,26,26,26,59,59,59,59,60,61,2,2,8,9,9,10,9,9,10,
