13,14,13,13,13,13,13,13,13,13,13,13,13,13,13,13,13,13,13,13,13,13,14,13,13,13,13,13,13,13,
13,13,13,14,13,13,13,13,13,14,23,17,18,17,18,17,18,17,18,17,22,13,13,13,14,14,14,14,13,14,
13,13,14,23,17,18,17,18,17,18,19,1,1,3,3,3,1,3,3,1,16,17,17,18,17,18,17,18,17,18,
17,18,17,19,2,3,2,2,3,3,2,0,62,55,55,55,55,55,3,0,3,1,1,1,3,0,3,3,1,3,
2,3,3,2,62,62,62,62,62,60,61,62,62,62,62,62,62,62,27,27,27,27,27,60,60,60,60,60,61,62,
27,27,27,27,27,27,27,27,27,27,27,27,27,27,27,27,27,60,60,60,60,60,60,61,62,27,27,60,61,62,
60,60,60,60,60,60,60,60,60,60,60,60,60,60,60,60,60,60,61,62,60,60,60,60,60,60,60,60,60,61,
60,60,61,62,61,62,62,62,62,62,62,62,62,62,62,62,62,62,62,29,29,29,29,29,29,29,29,29,29,29,
62,27,28,29,29,27,27,27,27,27,27,27,27,27,27,27,27,60,61,62,62,62,62,62,62,62,62,62,62,62,
27,27,27,27,27,60,60,60,60,60,60,60,60,60,60,60,60,60,61,62,29,29,62,62,60,61,62,62,27,60,
60,60,60,60,60,61,62,60,60,61,62,29,29,29,62,62,62,62,62,62,62,62,29,29,62,60,60,27,60,60,
29,27,28,29,29,62,62,27,28,29,29,62,62,62,62,27,28,29,29,60,61,62,62,62,29,29,61,60,60,61,
27,28,29,29,62,27,28,29,29,62,62,29,29,29,27,27,28,29,27,28,29,60,60,61,62,62,27,60,61,62,
28,29,29,62,27,28,29,29,62,29,29,62,62,62,29,29,29,29,29,29,29,29,27,60,61,27,60,61,62,60,
28,29,27,28,29,29,62,62,62,62,62,62,60,61,62,62,62,62,62,62,62,27,60,60,61,60,60,61,62,60,
29,27,28,29,29,62,62,29,29,29,61,62,28,60,61,62,27,27,27,27,27,60,60,60,27,60,61,62,60,60,
27,28,29,62,62,62,29,29,29,62,61,62,29,62,27,27,60,60,27,27,60,27,27,27,60,60,61,62,60,61,
29,29,62,28,29,29,62,62,62,62,29,62,27,27,27,27,27,27,27,27,27,27,27,60,60,61,62,61,62,62,
29,62,27,27,27,27,28,29,27,27,27,27,60,60,27,27,27,27,27,27,60,60,60,61,62,61,62,29,61,62,
29,60,60,60,60,27,27,27,27,27,27,27,27,27,27,27,60,60,60,60,60,61,62,61,62,62,62,29,61,62,
27,27,27,27,27,27,27,60,60,60,60,60,60,60,60,60,61,62,60,61,62,28,60,60,61,62,29,62,61,62,
60,60,60,60,60,60,60,61,62,60,60,60,60,60,60,60,61,62,60,61,62,27,60,61,62,61,62,62,29,62,
60,60,60,60,60,60,60,60,61,62,62,62,60,60,61,62,29,62,60,61,27,60,60,61,62,29,29,29,62,62,
27,28,29,62,60,27,27,28,29,62,62,27,60,61,62,29,62,29,27,27,60,60,61,62,29,62,62,62,62,62,
28,29,29,27,60,60,60,27,27,28,29,60,61,62,29,62,27,27,60,60,60,61,62,62,62,62,61,62,62,29,
28,27,27,60,60,61,62,60,60,27,27,27,27,27,27,27,60,60,60,61,62,62,62,61,62,61,62,62,61,62,
27,60,60,60,61,62,60,61,62,60,60,60,60,60,60,60,60,61,62,60,61,62,62,60,61,62,61,62,61,62,
60,60,61,62,27,60,60,61,62,61,62,27,28,29,27,27,27,27,60,60,61,62,62,61,62,60,61,62,61,62,
60,61,62,27,60,60,61,62,62,60,27,27,27,28,29,60,60,27,27,60,61,62,62,29,61,60,61,62,61,62,
62,60,60,60,60,61,62,62,60,61,27,60,27,28,29,28,27,60,60,60,61,62,27,27,28,60,61,62,61,62,
