60,60,60,60,60,60,60,60,60,60,60,60,60,60,60,60,60,60,60,60,60,60,60,60,60,60,60,60,61,62,
61,62,62,62,62,62,62,62,62,62,62,62,62,62,62,62,62,62,62,62,62,62,62,27,28,29,29,29,29,62,
60,60,61,62,29,27,60,60,60,60,60,60,60,60,27,28,29,29,29,29,29,29,29,29,29,29,62,62,29,27,
62,62,62,62,62,29,29,29,29,29,29,29,29,29,29,29,62,62,62,62,62,62,62,62,62,62,29,62,62,27,
27,60,60,60,61,62,62,62,62,62,62,62,62,62,62,62,29,29,29,29,29,62,62,27,28,29,62,60,27,28,
29,60,61,62,62,62,29,29,29,29,29,29,29,29,29,29,29,62,62,62,27,28,29,28,29,62,61,27,28,29,
29,62,27,27,60,61,62,62,62,62,62,62,62,62,62,62,62,60,60,27,28,29,29,29,62,61,62,27,28,29,
62,27,27,60,60,61,62,27,27,27,60,60,61,62,60,61,62,62,27,27,27,27,28,29,61,62,27,28,29,62,
27,60,60,61,62,27,27,27,60,60,60,61,62,62,62,62,27,27,27,60,60,27,28,29,62,27,28,29,29,62,
60,61,62,28,27,27,27,27,60,61,62,62,62,62,27,27,60,60,60,61,27,28,29,62,27,28,29,62,62,27,
61,62,29,27,27,60,60,60,60,61,62,27,27,27,60,60,60,61,62,27,28,29,62,27,28,29,62,61,62,27,
62,29,27,60,60,60,61,60,61,62,29,60,60,60,61,62,27,28,29,29,29,62,27,28,29,29,60,61,62,27,
29,27,60,60,61,62,62,60,61,62,62,29,29,29,29,29,29,29,29,62,62,27,28,29,62,62,61,62,62,29,
27,60,60,61,62,29,27,60,60,61,62,62,62,62,62,62,62,62,62,27,28,29,29,62,27,60,61,62,62,29,
60,60,61,62,62,62,60,60,61,62,29,29,62,62,62,60,61,62,27,28,29,62,62,60,27,60,61,62,62,29,
60,61,62,62,27,27,60,61,62,62,62,62,60,27,60,61,62,27,28,29,62,62,60,60,60,61,62,61,62,29,
61,62,61,27,60,60,27,28,29,62,27,27,60,60,61,62,27,28,29,62,62,61,60,27,60,61,62,60,61,62,
61,62,27,60,61,27,28,29,29,27,27,60,27,60,61,62,29,29,62,62,60,27,60,60,61,62,60,60,61,62,
61,62,60,60,61,27,28,29,62,60,60,60,60,60,61,62,62,62,62,27,27,60,27,60,61,62,60,60,61,62,
61,27,60,61,62,27,28,29,28,27,60,27,60,61,62,29,62,27,27,60,60,27,60,61,62,62,60,60,61,62,
27,60,61,62,27,28,29,29,28,60,60,60,60,61,62,62,27,45,29,29,29,27,60,61,62,28,60,61,60,61,
28,29,62,62,27,28,29,62,29,27,27,60,61,62,62,27,27,27,27,27,27,60,61,62,62,28,60,61,60,61,
28,29,29,61,27,28,29,27,28,27,60,60,60,60,60,60,60,60,60,60,60,60,61,62,60,27,60,61,60,61,
28,29,62,27,28,29,62,29,45,60,60,61,62,60,60,60,60,61,62,60,60,60,60,60,27,60,60,61,60,61,
28,29,62,28,29,62,29,62,62,60,61,62,62,29,62,60,61,62,45,29,29,29,62,27,27,27,60,61,60,61,
28,29,62,28,29,62,62,27,27,27,60,61,38,62,29,29,27,27,45,28,29,62,27,60,60,60,60,61,60,61,
28,29,62,27,27,27,27,60,60,60,60,60,60,61,62,62,29,60,60,27,27,27,60,60,61,62,60,61,62,29,
27,27,38,60,60,60,60,61,62,28,29,29,60,60,61,62,62,38,29,29,29,29,60,61,62,29,60,61,62,62,
27,60,60,38,61,62,29,38,27,28,45,45,62,60,61,60,38,38,62,62,62,62,45,61,62,29,60,60,61,62,
27,60,60,61,60,61,62,62,29,29,44,62,62,62,60,60,61,62,62,29,29,29,29,60,61,62,29,60,61,62,
