27,28,29,29,29,29,27,28,29,29,29,29,29,29,29,29,29,29,29,60,60,1,2,12,9,9,10,9,9,10,
28,27,28,29,27,27,28,29,29,62,27,28,29,29,27,28,29,62,60,60,1,2,4,20,9,10,10,10,9,10,
27,28,29,29,60,60,60,60,62,27,28,29,62,62,27,28,27,28,29,1,2,2,12,9,10,9,9,9,10,10,
27,28,29,60,60,28,29,60,60,28,60,60,60,62,27,28,60,61,62,1,2,4,20,9,10,9,9,9,10,10,
27,28,29,27,27,28,29,27,28,29,29,28,60,60,60,27,60,61,62,1,2,12,9,10,10,9,9,9,10,10,
27,28,29,27,27,28,60,27,28,29,62,29,60,27,60,60,27,28,29,1,2,8,9,10,10,9,10,9,10,10,
27,28,29,27,28,29,60,27,28,29,28,29,27,60,60,60,60,61,62,1,2,12,9,10,10,9,10,9,10,10,
27,28,29,27,28,29,60,27,110,109,109,109,109,109,109,110,110,61,62,1,2,8,9,10,10,9,10,9,10,10,
27,28,29,27,28,29,60,27,143,29,27,60,60,27,28,29,143,61,62,1,2,12,9,10,10,9,10,9,10,10,
27,27,27,28,29,29,60,60,110,29,60,60,60,27,27,28,110,61,62,1,2,8,9,10,10,9,10,9,10,10,
27,28,27,28,29,62,27,60,110,60,60,60,27,60,27,27,143,29,62,1,2,12,9,10,10,10,10,9,10,10,
27,28,27,28,29,62,60,60,110,60,60,60,27,28,60,27,143,28,29,1,2,8,9,9,10,10,10,9,10,10,
27,28,27,28,29,62,60,60,110,60,60,28,27,28,60,27,143,29,62,1,2,16,22,9,10,10,10,9,9,10,
27,28,27,28,29,27,28,60,110,60,60,28,27,28,29,27,143,28,29,1,1,2,8,9,10,9,10,10,9,10,
28,29,27,28,29,27,28,29,110,60,27,28,27,28,29,27,143,61,62,1,1,2,12,9,10,9,10,10,9,10,
28,29,27,28,29,27,28,29,110,60,60,118,118,118,62,60,143,28,29,1,1,2,8,9,9,10,9,10,10,10,
28,29,27,28,29,27,28,29,143,110,118,118,118,118,118,110,143,29,62,1,1,2,16,22,9,10,9,10,10,10,
28,29,27,28,29,27,28,29,28,143,118,118,118,118,118,143,29,62,1,2,2,1,2,8,9,10,9,10,10,10,
28,29,27,28,29,27,28,29,28,60,61,27,28,27,28,29,29,1,2,2,2,1,2,12,9,10,10,9,10,10,
28,29,27,28,29,27,28,29,60,60,61,27,28,60,61,62,62,1,2,1,2,1,2,8,9,10,10,9,10,10,
29,62,27,28,29,27,28,29,60,60,27,27,28,29,62,62,1,2,1,1,2,1,2,12,9,10,10,9,10,10,
29,27,27,28,29,27,28,60,60,60,60,27,28,29,61,62,1,2,2,2,2,2,4,20,9,9,10,10,10,10,
29,27,27,28,29,27,28,60,28,60,60,27,28,29,27,28,29,1,2,1,2,2,12,9,9,10,9,10,10,10,
29,27,27,60,60,27,28,60,28,60,60,27,28,29,60,61,62,1,2,1,2,2,8,9,10,10,10,9,10,10,
29,27,27,60,28,27,28,60,27,60,61,27,28,29,61,27,28,29,1,2,2,2,12,9,10,10,10,9,9,10,
28,27,60,60,28,27,28,60,27,60,61,27,28,29,61,27,27,28,29,1,2,2,8,9,10,10,10,9,9,10,
28,60,60,60,28,27,28,60,60,60,62,27,28,29,62,60,60,27,28,29,1,2,16,22,9,10,10,9,9,10,
27,60,61,27,28,27,27,27,60,61,27,27,27,27,27,60,61,60,61,62,1,2,2,16,22,9,10,9,10,10,
60,60,61,27,27,60,27,60,60,61,60,60,60,60,60,27,27,27,28,27,28,29,1,2,8,9,10,10,10,10,
60,61,62,60,27,60,60,60,61,62,60,61,62,29,62,60,60,60,61,60,61,62,60,3,12,9,10,10,9,10,
