27,27,27,27,27,28,29,29,29,29,29,29,29,29,29,29,29,29,29,29,29,29,29,29,29,29,29,29,29,29,
29,29,29,29,29,29,29,62,62,62,62,62,62,62,62,62,62,62,62,62,62,62,62,62,62,62,62,62,62,62,
29,29,29,29,29,29,29,29,29,29,29,29,29,29,29,29,29,29,29,29,27,27,27,27,27,27,27,27,27,27,
29,29,29,29,29,29,29,29,62,62,62,62,62,62,62,62,62,62,62,62,29,29,29,29,29,29,29,29,60,60,
62,62,62,62,62,62,62,62,29,29,29,27,27,27,27,27,27,27,27,28,29,27,27,27,27,28,29,62,29,29,
27,27,27,60,27,27,27,27,27,27,27,60,60,60,60,60,60,60,27,27,27,27,27,27,27,28,29,29,27,27,
27,27,27,27,28,29,29,29,29,29,29,29,29,29,29,29,29,29,29,29,60,60,60,60,60,27,27,27,27,27,
27,28,29,29,29,62,62,62,27,27,27,27,27,27,27,27,27,27,27,27,27,27,27,27,27,27,28,29,28,29,
27,27,27,27,27,27,27,27,27,27,27,28,29,60,60,60,60,60,60,60,60,60,60,60,60,60,27,27,27,27,
29,29,29,29,29,29,29,29,29,29,29,29,29,29,27,27,27,27,27,27,27,27,27,27,27,27,27,27,27,28,
27,27,27,27,27,28,29,29,29,29,29,29,27,27,27,27,27,28,29,29,60,60,60,60,60,27,28,29,29,29,
29,29,29,29,29,29,29,62,62,62,62,62,29,29,29,29,29,29,29,27,27,27,27,27,27,27,27,27,27,27,
62,62,62,62,62,62,62,27,28,29,29,29,29,27,27,27,27,27,27,27,27,27,27,27,27,27,27,28,29,28,
29,29,29,29,29,29,29,29,29,29,62,62,62,29,29,29,29,29,29,29,60,60,60,60,60,60,27,27,27,27,
29,29,29,29,29,29,29,29,29,62,60,61,62,62,62,27,27,27,27,27,27,27,27,27,27,27,27,28,29,29,
62,62,62,62,62,62,62,62,62,29,29,29,29,29,29,60,60,27,27,27,27,27,27,27,27,27,28,29,27,27,
27,27,27,27,28,29,27,27,27,27,27,27,27,27,27,27,28,29,27,27,27,27,27,27,27,28,29,27,28,29,
27,27,27,27,27,27,27,60,60,60,60,60,60,60,60,60,27,27,27,27,27,27,27,27,27,27,27,28,29,28,
60,60,60,60,60,60,60,61,62,60,60,60,60,60,60,60,60,60,60,60,60,60,60,60,60,60,27,27,27,28,
62,29,60,60,60,60,60,61,62,27,27,27,27,27,27,27,27,27,27,27,27,27,27,27,27,27,27,27,27,28,
62,62,27,27,27,27,27,27,27,27,27,27,27,27,27,27,27,27,27,60,60,60,60,60,60,60,60,27,28,29,
27,27,27,27,60,60,60,60,60,60,60,60,60,60,60,60,60,60,60,61,62,27,28,29,29,62,62,60,27,27,
60,60,60,60,61,62,27,27,27,27,27,27,27,27,27,27,27,27,27,27,28,29,27,27,27,27,27,28,29,60,
62,29,29,27,27,27,60,60,60,60,60,60,60,60,60,60,60,60,60,27,27,27,27,27,28,29,27,27,27,28,
27,27,27,27,27,27,28,29,62,27,27,27,60,60,60,60,60,60,60,60,60,60,60,27,28,29,60,60,60,27,
60,60,60,60,60,27,27,28,29,60,60,60,60,61,62,61,60,60,60,27,60,60,27,28,29,29,62,62,62,60,
27,27,27,28,27,27,27,28,29,29,29,62,29,29,29,29,60,61,62,27,27,28,29,29,29,62,27,28,29,27,
27,27,27,27,27,60,60,61,62,62,62,29,29,62,62,29,29,27,28,29,29,29,29,62,62,62,29,29,29,29,
60,60,27,27,27,28,29,62,62,29,29,29,29,29,27,28,29,29,29,29,62,62,62,62,62,29,29,62,62,62,
61,62,60,60,60,61,62,61,27,28,29,29,29,29,29,29,62,62,62,62,62,62,60,61,62,62,62,62,62,62,
