45,44,38,44,39,45,45,52,55,29,61,62,27,28,29,61,62,29,62,28,28,28,29,28,62,27,60,61,62,62,
44,38,38,38,38,45,45,41,62,29,61,62,29,29,29,61,62,29,28,28,61,61,29,28,62,27,60,61,62,62,
44,38,39,38,45,45,40,41,28,62,61,61,29,62,62,61,62,29,62,61,61,28,61,28,29,60,61,62,60,61,
38,38,38,38,45,39,52,28,62,62,61,61,62,62,60,61,62,29,61,61,61,28,61,28,62,60,61,62,60,61,
38,44,38,45,38,40,41,28,62,62,61,61,61,62,60,28,28,28,61,61,27,28,29,28,27,60,28,28,60,28,
38,39,38,39,39,40,41,28,62,29,61,62,28,28,28,28,61,29,62,61,27,28,29,28,60,28,28,29,60,28,
38,38,38,39,39,52,28,61,28,28,28,28,61,61,60,61,62,29,62,27,28,28,28,28,28,61,28,29,60,28,
44,38,44,39,52,28,28,60,61,62,29,62,62,61,61,28,28,28,28,28,28,28,61,28,60,28,28,29,28,61,
44,38,39,40,41,27,28,28,28,28,28,28,28,28,28,28,62,29,62,27,28,61,61,28,60,28,62,62,28,61,
39,38,39,40,41,28,29,29,61,62,62,62,62,61,61,61,62,29,27,28,61,61,60,28,61,28,62,28,62,61,
38,38,39,40,41,28,29,62,60,61,62,61,28,61,61,61,62,29,61,61,29,62,60,28,61,28,28,28,62,29,
38,38,39,39,34,35,28,29,60,61,62,61,28,61,61,61,61,61,27,28,29,60,61,28,61,28,28,60,61,62,
44,38,39,38,44,32,33,32,33,34,35,61,28,29,61,61,61,61,27,28,29,60,61,28,28,28,62,60,61,62,
44,38,38,38,38,38,38,44,45,46,47,61,28,28,61,61,62,61,28,29,62,60,61,28,28,28,62,28,60,61,
44,38,45,45,45,45,45,45,44,40,41,61,61,28,28,61,62,27,61,29,27,60,27,28,28,62,61,28,60,61,
38,38,38,38,38,38,45,44,44,52,62,61,61,29,28,28,62,27,61,61,60,60,28,61,28,61,61,28,60,61,
38,38,45,44,44,44,44,44,40,41,61,61,29,29,61,28,28,27,28,61,61,28,60,61,28,61,61,28,60,61,
38,44,38,44,44,44,44,51,52,61,61,62,62,29,60,61,27,28,29,28,28,61,62,29,28,61,62,61,29,60,
38,44,38,39,50,51,52,62,29,61,61,62,62,29,60,61,61,28,28,28,28,61,62,29,28,28,62,61,29,60,
38,44,38,40,41,28,29,29,29,61,61,62,62,29,60,61,27,61,28,28,28,28,28,29,28,28,62,61,29,60,
44,44,38,40,41,28,29,62,62,61,62,29,62,29,60,61,27,28,61,61,61,62,28,28,28,28,28,61,28,60,
44,44,38,40,41,28,29,62,60,61,62,29,28,29,60,61,27,61,29,60,28,28,28,28,28,28,28,61,28,60,
44,44,38,40,41,28,29,60,61,62,29,27,28,28,60,61,61,28,28,28,28,61,61,61,28,28,28,61,28,60,
44,44,38,40,41,29,29,60,61,62,28,28,29,28,28,61,28,28,29,61,62,61,62,61,28,28,28,27,61,60,
44,44,44,40,41,29,29,61,61,28,28,29,29,62,28,28,27,28,29,61,62,61,62,28,28,28,28,60,61,60,
44,45,44,40,41,29,29,28,28,28,62,29,28,28,28,28,27,28,29,62,60,61,62,28,28,28,61,61,61,60,
45,45,39,52,29,29,28,28,61,28,28,28,28,62,29,28,60,27,28,29,60,61,62,28,28,61,62,60,61,61,
45,39,52,28,28,28,28,62,28,28,28,61,61,62,62,28,60,27,28,29,60,61,28,28,28,61,62,60,61,61,
45,40,41,28,29,62,62,62,28,62,61,61,60,61,62,28,60,27,28,29,60,28,28,61,28,61,62,60,61,60,
45,40,41,28,29,62,62,62,28,28,28,27,60,61,62,28,28,27,27,28,28,28,61,28,28,28,62,61,62,60,
