27,26,27,28,60,61,28,61,26,27,28,28,61,60,26,27,28,26,26,27,28,27,0,1,12,9,10,10,9,10,
26,27,28,28,60,61,28,59,26,27,28,28,59,26,27,28,61,59,26,27,28,0,1,4,20,9,10,9,10,10,
26,27,28,61,60,61,61,59,26,27,28,28,26,26,27,28,61,59,59,60,61,0,1,8,9,10,10,9,10,10,
26,27,28,59,60,61,28,59,26,27,28,61,26,26,27,28,26,26,27,28,0,1,1,12,9,10,9,10,10,10,
26,27,28,59,60,61,28,59,26,27,28,26,27,26,27,28,59,26,27,28,0,1,4,20,9,10,9,10,10,10,
27,28,61,59,60,61,61,59,26,27,28,26,27,26,27,28,59,59,60,61,0,1,12,9,10,9,10,10,9,9,
27,28,27,59,60,61,61,26,27,28,61,26,26,27,28,61,26,27,28,0,1,1,8,9,10,9,10,10,9,9,
27,28,27,59,60,61,26,26,27,28,60,26,26,27,28,61,59,60,61,0,1,1,12,9,10,9,10,9,9,9,
27,28,27,59,60,61,59,26,27,28,60,26,26,27,26,27,28,28,28,0,1,1,8,9,10,9,10,9,9,9,
27,28,28,59,60,61,26,26,27,28,60,26,26,27,59,60,61,61,61,0,1,1,12,9,10,9,10,9,9,9,
27,28,28,59,60,61,59,26,27,28,26,27,26,27,26,27,26,27,28,0,1,1,8,9,10,9,10,10,9,9,
28,61,28,59,60,61,59,26,27,28,26,27,26,26,27,28,26,27,28,0,1,1,12,9,10,9,10,10,9,9,
28,28,61,59,60,61,59,26,27,28,26,27,26,26,27,26,27,28,28,0,1,1,8,9,10,9,10,9,9,9,
28,28,26,59,60,61,59,26,27,28,26,26,26,26,27,26,27,28,61,0,1,1,12,9,10,9,10,10,9,9,
28,28,59,60,61,59,26,27,28,61,26,26,26,27,28,26,27,28,61,0,1,1,8,9,9,10,9,10,10,9,
28,61,59,60,61,59,26,27,28,59,26,26,26,27,28,26,27,28,61,0,0,1,16,22,9,9,9,10,10,9,
28,28,59,60,61,59,26,27,28,59,26,26,26,27,28,26,27,26,27,28,0,1,1,8,9,9,10,10,9,9,
28,26,59,60,61,60,26,27,28,59,26,26,26,27,26,27,28,59,60,61,0,1,1,12,9,9,10,9,9,10,
28,59,59,60,61,60,26,27,28,26,26,26,26,27,26,27,28,59,60,61,0,1,1,8,9,9,10,9,9,10,
28,59,60,61,59,60,26,27,28,26,59,26,27,28,26,27,28,26,27,28,0,0,1,12,9,9,9,9,10,10,
28,59,60,61,59,60,26,27,28,26,59,26,27,28,26,27,28,59,60,61,28,0,1,8,9,9,9,10,9,9,
28,59,60,61,60,61,26,27,28,26,59,26,27,28,26,27,28,61,59,60,61,0,1,16,22,9,10,9,10,10,
28,60,61,59,60,61,26,27,28,26,26,26,27,28,26,27,28,61,59,60,61,0,0,1,8,9,9,9,10,10,
28,60,61,60,61,26,27,28,61,26,26,26,27,28,26,27,28,61,26,26,27,28,0,1,1,22,9,9,9,10,
27,28,59,60,61,26,27,28,26,59,26,26,27,28,26,27,28,61,59,59,60,61,0,1,1,8,9,9,9,10,
27,28,59,60,61,26,27,28,26,59,26,26,27,28,26,27,28,26,26,59,60,61,0,0,1,12,9,9,9,10,
27,28,59,60,61,26,27,28,26,59,26,26,27,28,26,26,27,59,26,26,26,27,28,0,1,8,9,10,9,10,
27,28,60,61,59,26,27,28,26,59,26,26,27,28,59,26,26,27,59,27,59,60,61,0,1,12,9,10,9,10,
26,27,28,61,60,26,27,28,26,59,26,26,27,26,59,26,59,60,61,27,27,27,0,1,1,8,9,9,9,10,
26,27,28,59,26,26,27,26,59,60,26,26,27,59,60,59,59,60,61,27,27,0,0,1,1,12,9,9,9,10,
