29,29,29,29,29,29,29,29,27,28,29,29,62,29,29,29,29,29,27,27,27,28,29,29,29,29,29,27,27,27,
62,62,62,62,62,62,62,62,27,28,29,62,62,27,28,29,28,29,27,60,27,28,29,62,62,29,29,29,29,29,
29,29,29,29,27,27,27,27,28,29,62,61,62,27,28,29,29,27,60,27,28,29,29,61,62,62,29,27,27,27,
27,27,27,27,27,60,27,28,29,29,60,27,27,27,28,29,62,60,60,27,28,29,27,28,29,29,29,29,27,27,
60,60,60,27,28,29,27,28,29,62,27,28,27,27,28,29,27,60,61,27,28,29,27,28,29,29,62,62,27,28,
29,27,28,29,29,27,28,29,62,27,28,29,27,27,28,27,60,61,27,28,29,27,28,29,29,62,60,27,27,28,
28,29,29,62,27,28,29,27,28,29,29,27,28,27,28,60,60,61,27,27,28,29,28,29,62,62,29,27,28,29,
29,29,62,27,28,29,29,27,28,29,62,27,28,27,28,60,61,62,27,27,27,28,29,62,61,62,62,27,27,27,
29,62,60,27,28,27,28,29,29,27,27,28,27,28,27,60,61,27,28,60,27,28,29,60,61,62,27,27,28,29,
27,27,27,28,29,27,28,29,27,27,27,28,27,28,60,61,62,27,28,27,27,28,29,29,61,27,28,29,28,29,
60,45,28,27,28,29,27,28,27,28,27,28,27,27,60,61,27,28,27,28,60,27,28,29,27,28,29,29,28,29,
60,27,28,27,27,28,29,27,27,27,28,29,27,60,60,61,27,28,27,28,29,27,28,29,27,28,29,62,28,29,
27,28,45,45,29,29,27,27,28,27,28,29,27,60,61,27,28,27,28,29,62,27,28,29,27,28,29,62,28,29,
27,27,27,28,45,27,27,28,29,27,28,29,27,60,61,27,27,28,29,27,27,27,28,29,27,28,29,62,29,29,
45,28,29,45,62,27,45,29,27,28,29,62,27,60,61,27,27,27,27,60,60,27,28,27,28,29,29,61,62,29,
27,28,29,45,27,45,28,27,28,45,62,62,27,60,27,27,27,60,60,61,62,27,28,27,28,29,62,61,62,29,
45,29,45,27,27,28,29,45,28,29,61,27,60,61,27,27,60,60,61,62,28,27,28,27,28,29,60,61,62,29,
29,62,60,27,27,28,27,28,29,29,61,60,27,27,60,60,61,62,28,29,29,27,27,28,29,62,60,61,62,29,
62,62,27,27,28,29,27,28,29,62,62,27,60,60,60,61,62,29,29,29,62,27,27,28,29,62,27,60,61,62,
29,60,45,27,28,29,27,28,29,61,27,60,61,62,28,29,29,62,62,27,27,28,29,29,62,62,27,60,61,62,
62,61,27,28,29,27,28,29,27,27,60,61,62,29,29,27,27,27,27,60,27,28,29,62,61,62,27,60,61,62,
27,27,27,28,29,27,27,27,60,60,61,62,27,27,27,60,60,60,27,28,29,29,62,62,61,62,27,60,61,62,
27,45,27,28,27,27,60,60,61,27,27,27,60,60,60,60,61,27,28,29,29,62,29,29,61,62,27,60,61,62,
27,27,28,29,27,60,45,27,27,60,60,60,60,61,62,27,28,29,29,62,62,29,62,29,62,29,27,60,61,62,
27,27,28,29,60,61,62,27,27,28,29,62,27,28,29,29,29,29,62,28,29,62,27,28,29,62,27,60,61,62,
27,28,29,62,27,28,27,60,60,61,62,29,29,29,29,62,62,62,28,29,29,60,27,28,29,27,27,28,60,61,
27,28,29,27,27,27,60,60,61,62,62,62,62,62,62,28,27,27,28,29,62,27,27,28,29,60,27,28,60,61,
27,28,27,60,60,60,61,62,60,61,62,62,29,61,27,27,27,28,29,62,27,60,60,27,28,29,27,28,60,61,
27,27,60,60,27,27,60,61,62,60,61,62,62,27,27,27,28,29,29,61,27,60,61,27,27,28,27,27,60,61,
27,27,60,27,27,60,60,61,62,60,60,61,62,29,27,28,29,29,62,27,60,60,61,60,60,27,27,60,61,62,
