27,27,28,29,62,62,29,29,29,29,29,62,62,62,27,27,28,29,29,29,60,61,62,27,28,29,29,27,27,27,
27,27,28,29,61,27,28,29,62,29,29,29,29,29,27,28,29,62,29,29,29,29,27,28,29,62,27,60,27,28,
27,27,28,29,27,27,28,29,27,28,29,29,62,27,28,29,29,29,62,62,27,28,29,29,27,27,27,28,29,29,
27,27,28,29,60,27,28,29,27,28,29,39,29,27,28,29,62,29,60,27,28,29,62,27,60,27,28,29,29,62,
27,28,29,62,60,60,27,27,28,29,29,62,27,28,29,39,39,39,39,28,39,39,27,60,27,28,29,29,62,62,
27,28,29,60,60,61,27,27,28,29,62,62,27,28,29,39,29,27,28,29,27,39,60,27,39,29,29,62,61,62,
27,28,29,27,60,61,27,28,29,62,62,27,28,29,62,27,28,29,27,27,60,39,27,28,39,27,27,28,29,29,
27,28,29,60,60,61,27,28,29,61,62,28,29,39,39,28,27,27,60,60,61,27,27,27,39,39,27,27,27,28,
27,28,29,60,61,27,28,29,62,61,62,28,27,28,27,27,60,39,61,62,27,27,39,27,27,39,28,29,27,28,
27,28,29,60,61,27,28,29,60,61,62,27,39,27,60,27,39,39,27,27,27,60,27,27,60,39,28,29,29,29,
27,28,29,60,27,28,29,62,60,27,27,27,60,27,27,60,39,60,39,39,27,27,27,60,60,39,28,29,28,29,
27,28,29,39,39,28,29,27,27,27,60,60,27,60,60,60,61,62,39,27,39,39,60,60,61,27,28,39,39,29,
27,28,29,27,28,29,27,27,60,60,60,27,60,61,62,61,27,39,39,60,39,60,60,61,27,28,29,29,39,29,
39,29,29,27,28,29,60,60,39,61,27,39,60,61,39,27,60,39,39,27,39,39,61,39,27,28,29,62,39,29,
28,29,27,27,28,29,60,61,62,27,60,60,61,62,39,60,39,60,39,27,39,39,39,39,28,29,29,39,39,29,
28,29,60,27,28,29,60,27,27,60,27,60,61,62,39,60,39,60,39,39,39,39,62,39,28,29,62,39,29,29,
28,39,27,28,29,27,28,27,60,61,60,61,62,60,39,61,60,61,27,39,61,62,39,39,28,29,29,62,29,62,
28,29,27,28,29,27,27,39,61,62,60,61,62,60,39,62,60,61,60,60,61,39,39,28,29,62,29,27,28,29,
39,27,27,28,29,27,60,61,62,28,60,61,62,29,61,62,39,27,60,39,62,39,39,29,29,29,62,27,28,29,
28,27,27,27,27,60,60,61,62,29,60,61,62,62,62,27,39,39,60,61,39,27,39,39,62,62,39,27,28,29,
28,27,60,39,39,60,61,62,39,29,62,60,61,62,62,60,61,60,61,39,39,28,29,39,29,29,39,27,28,29,
27,27,60,27,60,61,62,28,29,62,27,60,61,62,62,60,61,60,39,39,27,28,29,62,62,62,27,28,29,62,
27,60,60,27,60,61,62,29,62,27,60,60,39,62,29,60,39,39,39,60,27,27,28,29,62,29,27,28,29,62,
60,60,61,60,61,62,29,29,27,60,61,60,39,39,62,60,39,60,60,61,60,27,27,39,39,29,27,28,27,28,
60,61,62,60,61,62,29,62,27,60,61,60,60,39,39,60,61,60,61,39,39,60,60,27,27,27,27,27,28,29,
60,61,62,60,61,62,62,27,60,61,62,60,60,61,39,60,61,60,61,62,62,62,62,60,60,27,27,27,28,29,
60,61,62,60,61,62,27,27,60,61,62,60,61,60,61,60,61,62,62,62,29,29,62,29,39,60,27,27,28,29,
61,62,62,60,61,62,27,60,61,62,29,60,61,60,61,62,62,60,61,62,62,62,29,29,39,60,60,27,28,29,
62,62,29,60,61,62,60,60,61,62,62,60,61,62,60,61,62,60,61,62,62,29,29,62,39,60,61,27,28,29,
62,28,27,60,61,62,60,61,62,29,27,60,61,62,29,60,61,62,60,61,62,62,62,27,60,61,62,27,28,29,