27,27,27,27,27,29,29,29,27,27,27,29,29,27,27,27,27,27,27,28,29,60,61,62,27,27,60,60,60,60,
29,29,29,29,29,29,27,60,60,61,61,61,29,29,60,60,60,60,60,27,27,28,29,29,29,29,29,29,27,28,
38,62,29,29,27,38,60,61,61,61,61,61,61,29,61,60,38,60,60,60,60,27,27,28,29,29,29,27,28,29,
29,29,29,61,61,61,61,29,29,29,29,29,62,38,61,61,27,27,27,27,27,27,27,29,29,29,27,38,27,28,
29,27,60,61,38,61,60,61,62,29,61,27,27,27,27,61,61,27,61,61,61,61,27,60,60,38,29,29,29,29,
62,60,61,29,29,61,62,27,27,28,29,61,61,38,61,61,61,61,61,61,61,61,61,29,27,27,28,38,29,29,
27,60,61,38,29,29,38,29,29,29,29,27,27,61,38,38,29,61,61,61,61,60,60,29,29,27,28,29,62,62,
60,61,61,61,27,28,29,29,29,29,61,61,61,29,29,27,27,61,60,60,61,61,61,38,38,27,28,29,29,28,
62,60,61,28,29,29,38,62,62,27,27,62,61,61,61,61,61,61,60,61,27,27,28,38,29,61,61,62,29,29,
62,27,61,29,29,62,61,61,27,27,29,44,45,45,44,45,45,45,45,27,38,27,28,29,27,28,61,61,61,29,
27,29,61,62,62,61,27,61,61,27,44,45,45,45,45,45,45,45,45,45,29,29,29,29,29,28,29,29,28,29,
27,28,61,61,27,61,61,61,61,61,44,45,221,222,221,222,223,224,45,45,45,62,62,29,62,28,29,29,27,28,
28,29,62,61,61,61,29,29,27,44,45,221,254,255,254,255,256,257,224,45,45,61,62,62,29,29,29,29,27,28,
28,29,27,60,61,61,27,29,29,44,221,223,224,224,224,257,257,257,257,224,45,29,60,61,62,62,29,29,60,61,
28,27,27,27,27,61,61,29,44,44,221,256,257,224,257,254,255,256,257,257,45,45,61,60,61,62,62,29,27,60,
28,38,61,62,27,38,29,38,44,44,221,222,223,224,29,61,254,255,256,257,45,45,45,62,60,61,62,62,29,60,
28,29,28,29,38,29,62,38,44,44,221,223,224,223,224,221,254,255,256,257,45,44,45,27,62,60,61,62,62,60,
28,29,29,29,29,29,61,61,44,44,254,256,257,222,223,221,222,223,224,257,44,44,45,27,27,29,60,61,62,62,
27,28,29,29,28,29,62,27,29,44,45,254,223,224,224,221,222,224,257,45,44,44,45,62,62,27,27,27,27,27,
27,28,29,27,28,61,38,27,62,44,44,45,256,254,255,254,255,257,45,45,44,45,27,27,27,27,27,27,27,27,
27,28,29,27,38,61,60,27,62,28,44,45,44,44,44,44,44,45,45,44,45,61,61,61,61,61,62,29,60,60,
60,27,28,29,29,38,60,27,29,29,44,44,45,44,44,44,44,44,44,45,61,61,61,61,27,61,61,29,27,60,
27,27,27,28,29,61,27,29,29,61,29,44,44,44,44,44,44,45,45,28,29,61,27,61,61,29,29,62,60,60,
60,60,27,28,29,61,29,29,27,29,29,60,61,38,61,44,45,28,27,28,61,61,61,62,61,29,27,27,60,61,
60,27,60,38,28,61,29,61,61,61,61,61,61,38,61,62,27,27,28,29,61,27,61,62,61,27,60,60,61,62,
61,61,61,27,27,61,61,61,61,62,29,60,27,62,38,62,29,27,27,61,61,27,27,27,61,60,60,61,62,60,
61,60,29,60,60,61,27,27,27,27,27,27,27,27,27,27,27,27,27,27,27,27,60,60,61,60,61,62,60,61,
61,61,29,61,61,61,60,60,27,27,29,29,38,29,29,29,29,29,60,60,60,60,60,61,61,60,27,60,60,61,
62,62,29,62,61,60,61,60,60,60,29,29,29,29,38,60,61,61,60,61,62,61,62,61,61,61,61,60,61,62,
61,62,62,29,29,29,29,29,29,29,29,61,38,62,29,61,61,61,61,61,60,61,62,62,29,60,60,61,62,61,
