9,9,9,9,10,10,10,11,2,1,1,2,3,3,3,3,1,2,3,1,1,1,2,3,1,2,3,44,45,45,
9,10,10,9,10,23,18,19,1,1,2,3,3,1,2,1,2,1,1,1,2,3,1,1,2,3,44,45,44,45,
9,9,9,10,23,19,1,1,1,2,3,3,1,2,1,1,1,1,2,3,3,3,2,3,44,45,45,45,44,45,
9,10,9,10,15,1,2,3,1,1,2,3,3,1,1,1,2,3,3,1,1,2,3,44,45,45,44,45,45,45,
9,10,9,10,21,7,2,3,1,1,1,1,1,1,1,1,1,1,2,1,2,3,44,45,45,44,45,45,44,45,
9,10,9,9,10,21,7,3,1,1,1,1,1,1,1,1,1,2,1,2,3,38,39,45,44,45,45,44,44,45,
10,10,9,10,10,10,21,6,7,1,1,1,1,1,1,1,1,2,3,38,39,38,39,45,44,44,45,44,44,45,
10,27,28,9,10,10,10,10,21,6,7,2,3,2,2,1,55,55,38,39,39,39,38,38,38,39,44,45,44,45,
10,27,27,27,28,9,10,10,9,10,21,6,55,55,60,59,59,59,60,38,38,38,38,39,44,45,44,45,44,45,
10,60,27,28,27,28,9,10,10,10,10,9,55,28,55,27,27,27,28,27,28,28,28,28,44,44,45,44,44,45,
10,10,27,27,60,27,28,28,9,10,9,10,60,61,28,60,60,27,28,27,28,61,61,27,28,44,45,44,44,45,
10,10,27,60,60,27,28,61,55,10,10,10,10,60,61,60,61,60,61,28,61,27,28,60,61,44,44,44,44,45,
10,10,60,60,61,27,27,27,27,28,9,10,10,10,27,28,61,27,28,28,61,27,28,27,27,28,44,45,44,45,
10,10,10,27,28,28,60,60,27,27,28,9,10,10,60,61,28,27,28,61,61,27,28,60,27,28,44,44,45,44,
9,10,10,27,28,28,60,61,60,27,28,9,10,9,10,60,61,27,28,28,61,60,61,27,28,28,44,44,44,44,
9,10,59,60,27,28,60,60,60,27,28,119,119,119,119,27,28,28,28,61,61,27,60,27,28,61,44,45,44,44,
10,10,59,60,27,28,60,61,27,28,28,119,119,119,119,27,27,28,28,61,61,28,60,27,27,28,44,45,44,44,
10,9,10,27,28,28,60,61,27,27,28,9,10,9,10,60,27,28,61,61,28,28,60,27,60,61,44,45,44,44,
10,9,10,27,27,27,60,61,60,27,28,9,10,10,10,27,28,28,61,28,61,28,60,60,60,61,44,45,44,45,
9,10,27,28,60,27,60,61,27,28,61,9,10,10,27,60,61,61,28,28,60,61,60,60,61,28,44,44,44,45,
9,10,60,61,60,27,60,61,60,61,9,10,10,10,60,61,28,28,28,61,60,61,61,60,61,61,28,44,44,45,
9,10,60,27,60,60,60,60,61,9,10,10,10,27,28,28,28,61,28,27,60,61,61,60,60,60,61,28,44,45,
9,10,27,27,60,61,60,61,9,10,10,10,27,60,61,28,61,28,61,60,61,60,61,60,61,27,60,61,44,45,
10,27,28,60,60,61,9,10,10,10,27,28,60,61,28,28,28,61,61,60,61,60,61,60,61,27,27,28,44,45,
10,60,61,60,61,9,10,10,10,27,60,61,28,28,28,61,61,60,61,60,61,60,27,60,61,60,27,28,44,45,
10,10,27,28,9,10,10,27,28,60,61,28,28,61,61,28,28,28,28,61,60,60,27,28,60,61,60,61,44,45,
9,10,60,61,9,10,27,60,61,28,28,28,61,28,61,61,61,61,61,61,60,61,27,28,60,61,28,44,44,45,
9,10,9,10,10,10,60,61,61,61,61,61,61,27,28,28,28,60,61,61,60,61,27,28,60,61,28,44,44,45,
9,10,9,10,10,27,28,28,28,28,28,28,28,28,28,61,27,27,27,27,27,27,27,27,60,61,28,44,44,45,
9,10,9,10,27,28,61,61,61,61,61,61,61,61,61,61,60,60,60,60,60,60,60,60,60,61,61,44,44,45,
