38,46,47,28,29,29,29,62,29,29,62,62,62,29,29,29,29,29,29,60,61,62,62,62,27,28,29,29,29,29,
38,46,47,27,28,29,62,62,62,62,29,29,62,62,62,29,62,62,29,29,60,61,62,62,29,29,29,62,62,62,
38,46,47,27,28,29,28,60,61,62,62,62,29,29,62,62,61,62,62,62,29,61,62,62,62,62,62,29,61,62,
38,46,47,28,29,29,27,28,60,61,62,61,62,62,61,62,60,61,62,29,62,29,62,62,60,61,62,62,29,62,
38,46,47,61,62,29,27,27,60,61,62,60,61,62,61,62,60,61,62,62,62,62,62,29,62,60,61,62,62,61,
38,38,34,35,27,28,29,27,60,61,27,28,29,29,61,62,27,60,61,62,61,62,29,29,29,27,60,61,62,29,
38,38,52,47,28,29,29,60,60,27,28,29,29,62,28,29,60,60,61,62,61,62,62,62,62,27,28,60,61,62,
38,46,47,60,61,62,28,29,27,28,29,29,62,62,27,28,27,60,61,62,60,61,62,62,27,27,28,60,61,62,
38,46,47,61,62,27,28,27,28,29,29,62,61,62,27,27,60,61,62,60,61,62,62,62,27,27,28,60,60,61,
38,38,34,35,28,29,27,27,28,29,62,60,61,62,60,60,60,61,62,62,62,62,61,62,29,29,29,29,60,61,
39,38,46,47,61,62,29,28,29,29,60,61,62,28,29,27,27,60,61,62,62,61,62,29,29,62,62,62,29,60,
39,38,38,33,34,35,62,29,29,62,29,61,62,29,29,27,60,60,61,62,62,61,62,29,62,60,61,62,62,29,
39,38,38,38,46,47,28,29,62,62,29,27,28,29,27,60,60,61,62,62,61,62,29,62,27,27,28,60,61,62,
39,38,38,39,46,47,61,62,61,62,62,27,28,27,60,60,61,62,61,62,61,62,28,29,29,29,29,29,29,61,
39,38,38,39,38,34,35,60,61,62,28,27,28,29,60,61,62,60,61,62,61,62,29,29,62,62,29,62,62,29,
39,39,38,39,38,46,47,60,61,62,27,28,29,29,62,62,60,61,62,61,62,29,62,62,60,61,62,61,62,62,
38,39,38,39,38,46,47,61,62,29,27,28,29,62,62,27,60,61,62,61,62,62,62,29,60,61,62,60,61,62,
38,39,38,39,38,46,47,61,62,62,28,29,29,62,28,60,61,62,61,62,62,29,29,62,60,61,62,29,29,29,
38,39,38,39,39,46,47,60,61,62,28,29,62,62,27,60,61,62,61,62,62,62,62,29,60,61,62,62,62,62,
38,38,39,39,51,52,60,60,61,62,29,29,62,62,60,60,61,62,62,29,29,29,29,27,60,61,62,60,61,62,
118,118,118,118,118,118,118,118,118,118,118,118,118,118,118,118,118,118,118,118,118,118,118,118,118,118,118,118,118,118,
118,118,118,118,118,118,118,118,118,118,118,118,118,118,118,118,118,118,118,118,118,118,118,118,118,118,118,118,118,118,
38,38,46,47,28,29,27,28,29,29,61,62,62,61,62,61,62,62,62,62,27,27,60,61,62,29,61,60,61,62,
38,39,52,61,61,62,27,28,29,62,61,62,62,60,61,62,62,27,27,28,27,60,60,61,62,62,27,60,61,62,
39,46,47,28,29,27,28,29,62,60,61,62,60,61,62,62,27,28,29,27,60,60,61,62,61,62,60,60,61,62,
39,46,47,61,62,28,29,29,60,61,62,60,60,61,62,27,28,27,27,60,60,61,62,60,61,62,60,61,62,61,
38,52,60,61,62,28,29,62,60,61,62,29,62,28,27,28,27,60,60,61,62,27,60,60,61,62,60,61,62,61,
46,47,28,29,28,29,62,60,61,62,29,62,29,27,27,27,60,60,61,62,60,60,61,62,62,60,61,62,61,62,
52,60,61,62,27,28,29,60,61,62,27,27,27,27,60,60,61,62,60,60,61,62,61,62,62,60,61,62,62,27,
61,27,27,27,60,61,62,60,60,60,60,60,60,60,60,61,62,62,61,62,61,62,61,62,60,61,62,62,27,60,
