26,27,28,28,28,28,28,28,28,28,28,61,26,27,28,28,26,27,28,28,28,28,26,27,26,27,28,28,61,61,
27,28,61,61,61,61,61,26,26,27,28,28,28,26,27,28,28,28,61,26,27,28,26,27,26,27,28,61,60,61,
26,26,26,26,27,28,26,27,28,28,26,27,28,28,28,61,26,27,26,27,28,28,28,28,28,27,28,59,60,61,
59,26,27,26,27,28,28,28,26,27,28,28,61,61,26,27,28,26,27,28,28,61,61,61,61,28,61,59,60,61,
28,26,27,28,28,61,61,26,27,28,61,61,26,26,27,26,26,27,28,28,28,28,28,60,61,61,28,28,60,61,
26,27,28,26,27,28,28,28,28,61,26,27,26,26,118,118,118,28,28,61,61,61,61,28,28,28,28,61,28,61,
28,28,61,26,27,28,61,61,26,27,28,26,59,118,109,109,110,118,28,28,28,60,61,61,61,61,61,28,61,28,
28,26,27,28,28,26,27,28,26,26,26,27,28,118,109,142,143,118,61,61,61,28,61,27,59,60,61,61,61,61,
26,27,28,61,26,26,26,26,26,27,28,28,61,118,142,142,143,118,59,60,61,61,61,27,26,59,60,61,60,61,
28,28,26,26,26,59,26,27,28,28,61,61,27,28,118,118,118,59,59,59,60,61,26,26,59,59,60,61,60,61,
26,26,26,59,59,26,27,28,26,27,28,28,28,28,28,28,28,28,60,61,28,26,26,26,27,28,28,28,60,61,
59,59,59,60,26,26,27,28,28,28,61,61,61,61,61,61,61,61,26,26,26,59,26,27,28,28,26,26,27,28,
60,61,26,26,27,28,28,61,61,61,26,26,26,59,59,59,60,61,26,59,59,26,27,28,28,26,26,26,27,28,
61,26,27,28,28,26,27,28,28,28,28,28,28,28,28,28,28,59,59,59,60,26,27,28,26,59,26,26,27,28,
26,27,28,26,27,26,27,28,61,61,61,61,61,61,61,61,61,28,59,59,26,26,26,26,59,59,26,26,27,28,
27,26,27,28,28,26,26,26,27,28,61,26,26,26,59,59,60,61,26,26,59,59,59,26,27,28,28,26,27,28,
26,26,26,27,28,59,26,27,28,28,61,59,26,26,26,26,26,26,59,59,59,26,27,28,27,28,28,28,27,28,
26,27,28,26,26,26,26,26,26,27,28,28,28,28,28,28,28,59,59,60,26,27,28,28,27,28,61,61,28,28,
26,26,26,59,59,59,59,59,26,26,26,26,26,27,28,61,61,28,28,28,28,28,28,61,26,27,28,61,61,28,
59,59,59,59,60,61,59,60,59,59,59,59,59,60,61,60,61,61,61,61,61,61,61,59,59,60,61,60,61,61,
118,118,118,118,118,118,118,118,118,118,118,118,118,118,118,118,118,118,27,27,27,27,27,27,27,27,27,28,27,28,
118,118,118,118,118,118,118,118,118,118,118,118,118,118,118,118,118,118,60,60,60,60,60,60,60,60,60,61,60,61,
26,27,28,28,26,27,26,27,28,26,27,28,28,28,28,28,118,118,28,26,27,28,28,28,28,28,28,28,28,28,
26,27,28,61,59,60,59,60,61,28,28,28,61,61,61,61,118,118,61,28,28,28,61,61,61,61,61,61,61,61,
26,27,28,28,59,60,61,28,61,61,61,61,59,60,61,61,118,118,61,61,61,61,61,61,61,61,61,61,61,61,
26,27,28,61,59,60,61,61,28,28,26,27,26,26,26,26,118,118,26,26,26,59,59,59,59,59,59,59,60,61,
26,27,26,27,28,28,28,61,26,26,26,26,59,59,59,59,118,118,59,59,59,60,61,59,59,59,59,60,61,28,
26,26,26,26,26,27,28,28,59,59,59,59,59,60,61,26,118,118,28,59,59,59,60,61,61,61,61,61,28,28,
59,59,59,59,59,26,26,26,26,26,26,26,26,26,26,27,118,118,61,59,60,61,61,61,28,28,28,28,28,28,
59,60,61,26,26,59,59,59,59,59,59,59,59,26,26,26,118,118,26,26,26,59,60,61,61,61,61,61,61,61,