27,27,27,27,27,27,27,27,27,27,27,27,27,27,27,27,27,27,27,27,44,27,27,27,27,27,27,27,27,27,
29,29,29,29,29,44,29,29,29,29,29,44,29,29,29,29,29,29,29,44,29,29,29,29,29,29,29,29,29,29,
27,27,27,27,27,27,27,27,27,27,27,44,27,27,27,27,27,27,27,27,27,27,27,27,27,27,28,29,29,29,
29,29,29,29,29,29,29,29,29,29,29,29,29,29,29,29,29,29,29,29,29,29,29,29,29,29,29,62,62,62,
27,27,27,27,27,27,27,27,27,27,27,27,27,27,27,27,27,27,27,27,27,27,27,27,27,27,27,27,27,27,
60,60,60,60,60,60,60,60,60,60,60,60,60,60,60,60,60,60,60,27,28,29,29,29,29,29,29,29,29,29,
27,27,27,27,27,27,27,27,27,27,27,27,27,27,27,27,27,27,27,27,27,27,27,27,27,27,27,27,27,27,
29,29,29,29,29,29,29,29,29,29,29,29,29,29,29,29,29,29,29,29,29,29,29,29,29,29,29,29,29,29,
27,27,27,27,27,27,27,28,29,62,62,62,62,62,62,62,62,62,62,62,62,62,62,62,62,62,62,62,62,62,
29,29,29,29,29,29,29,29,29,29,29,29,29,29,29,29,29,29,29,29,29,29,29,29,29,29,29,29,29,29,
62,62,62,62,62,62,62,62,62,62,62,62,62,62,62,62,62,62,62,62,62,62,62,62,62,62,62,62,62,62,
27,27,27,27,27,27,27,27,27,27,27,27,27,27,27,27,27,27,27,27,27,27,27,27,27,27,27,27,27,27,
29,29,29,29,29,29,29,29,29,29,29,29,29,29,29,29,29,29,29,29,29,29,29,29,29,29,29,29,29,29,
62,62,62,62,62,62,62,62,62,62,62,62,62,62,62,62,62,62,62,62,62,62,62,62,62,62,62,62,62,62,
29,29,29,29,29,29,29,29,29,29,29,29,29,29,29,29,29,29,29,29,29,29,29,29,29,29,29,29,29,29,
62,62,62,62,62,62,62,62,62,62,62,62,62,62,62,62,27,27,27,27,27,27,27,27,27,27,27,27,28,29,
29,29,29,29,29,29,29,29,29,29,29,29,29,29,29,29,29,29,29,29,29,29,29,29,29,29,29,29,29,29,
29,62,62,62,62,62,62,62,62,62,62,62,62,62,62,62,62,62,62,62,62,62,62,62,62,62,62,62,62,62,
27,27,27,27,27,27,27,27,27,27,27,28,29,29,29,29,29,29,29,29,29,29,29,29,62,62,62,62,62,62,
60,60,60,60,60,60,60,60,60,60,60,27,27,27,27,27,27,27,27,27,27,27,27,27,27,27,27,27,28,29,
118,118,118,118,118,118,118,118,118,118,118,118,118,118,118,118,118,118,118,118,118,118,118,118,118,118,118,118,118,118,
118,118,118,118,118,118,118,118,118,118,118,118,118,118,118,118,118,118,118,118,118,118,118,118,118,118,118,118,118,118,
27,27,27,27,27,27,27,27,27,27,27,27,27,27,27,27,27,27,27,27,27,27,27,27,27,28,29,27,28,29,
60,60,60,60,60,60,60,60,60,60,60,60,60,60,60,60,60,60,60,60,60,60,60,60,60,61,62,62,27,27,
29,29,62,62,27,27,27,27,27,27,27,27,27,27,27,27,27,27,27,27,27,27,27,27,27,27,27,27,60,27,
27,27,27,27,60,60,60,60,60,60,60,60,60,60,27,28,29,29,29,29,29,29,29,29,29,29,29,29,29,29,
28,29,29,29,29,29,29,29,29,29,29,29,29,29,29,29,62,62,62,62,62,62,62,62,62,62,62,27,27,27,
27,27,27,27,27,27,27,27,27,27,27,27,27,27,27,27,27,27,27,27,27,28,29,29,27,27,27,27,27,27,
27,27,27,27,27,27,27,27,27,27,27,27,27,27,27,27,27,27,27,27,27,27,27,27,27,27,27,27,28,29,
60,60,60,60,60,60,60,60,60,60,60,60,60,60,60,60,60,60,60,60,60,60,60,60,60,60,60,60,61,62,
