13,14,13,14,27,27,28,29,29,29,62,62,62,29,29,29,29,62,29,29,29,118,118,29,27,27,28,44,45,45,
13,13,14,14,60,27,28,27,28,29,29,61,62,62,62,62,62,62,62,62,62,118,118,62,29,28,29,44,45,45,
14,14,13,14,27,28,29,28,29,29,29,60,61,62,29,27,60,61,62,29,29,118,118,29,62,29,29,44,45,45,
14,13,14,14,60,61,62,29,29,62,62,60,61,62,27,28,60,61,62,62,62,118,118,62,61,62,29,44,45,45,
14,13,13,27,28,29,27,27,28,29,29,61,62,29,27,27,60,61,62,27,60,118,118,29,60,61,62,44,45,45,
14,13,14,27,27,28,29,27,28,29,62,62,29,27,28,60,60,61,62,60,60,118,118,62,60,61,62,44,45,45,
14,13,14,60,27,28,29,27,28,29,62,29,27,28,27,60,61,62,27,60,61,118,118,61,62,60,61,44,44,45,
14,13,14,27,28,29,29,27,28,29,62,29,28,27,60,61,62,27,60,61,62,118,118,60,61,60,44,45,44,45,
14,13,14,60,61,62,62,27,28,29,62,29,27,60,60,61,62,60,61,62,28,118,118,62,60,60,44,44,44,45,
14,13,13,14,27,28,29,27,28,29,62,27,60,60,61,62,60,61,62,28,29,118,118,60,60,60,44,44,44,45,
13,14,13,14,27,28,29,27,27,28,29,60,60,61,62,61,62,62,28,29,29,118,118,29,60,60,44,44,44,45,
13,14,13,14,27,28,29,60,27,28,29,62,28,27,28,29,29,29,29,29,62,118,118,29,27,60,44,44,45,45,
13,13,14,14,27,27,27,28,29,28,29,62,28,27,28,29,62,62,29,62,28,118,118,27,60,60,44,44,44,45,
13,14,14,14,60,27,28,29,62,28,29,62,29,27,28,29,61,62,29,28,29,118,118,27,60,44,44,44,44,45,
13,14,13,14,14,27,28,29,60,61,62,62,27,28,29,62,60,61,62,29,62,118,118,60,60,44,45,45,44,45,
13,13,14,14,14,27,28,29,60,61,62,28,27,28,29,62,60,61,62,62,62,118,118,60,61,44,44,44,44,45,
13,13,14,14,14,27,28,29,60,61,62,29,27,28,29,62,29,60,61,62,27,118,118,61,62,44,44,44,44,45,
13,13,14,13,13,27,28,29,60,61,62,62,27,28,29,61,62,60,61,62,27,118,118,62,62,61,44,45,44,44,
13,13,14,14,13,27,28,29,27,60,61,62,27,28,29,61,62,60,61,62,29,118,118,62,61,62,44,44,45,44,
13,14,13,14,13,27,28,29,27,60,61,62,27,28,29,61,62,60,60,61,62,118,118,60,61,62,60,44,44,45,
13,14,13,14,13,27,28,29,27,60,61,62,27,28,29,61,62,29,60,61,62,118,118,118,118,118,118,118,118,118,
13,14,13,14,14,27,28,29,27,60,61,62,27,28,29,61,62,27,60,61,62,118,118,118,118,118,118,118,118,118,
13,14,13,14,14,27,28,29,27,60,61,62,27,28,29,61,62,60,60,61,62,60,61,62,29,60,61,62,44,45,
13,13,14,14,14,60,61,62,60,60,61,62,27,28,29,61,62,60,60,61,62,61,62,62,27,60,61,62,44,44,
14,14,14,14,13,14,27,28,29,61,62,29,27,28,29,61,62,27,60,61,62,62,29,27,60,61,62,60,61,44,
13,13,14,14,13,13,27,28,29,61,62,29,27,28,29,27,28,29,61,62,62,28,27,60,61,62,27,60,44,45,
13,14,13,14,13,14,27,28,29,61,62,29,27,28,27,28,29,29,29,62,27,27,60,60,61,62,60,61,44,45,
13,14,13,14,14,14,60,27,28,29,62,29,27,28,60,61,62,62,62,62,60,60,61,62,27,60,60,61,44,44,
13,14,13,13,14,13,14,60,27,28,29,29,27,28,29,60,60,61,62,62,60,61,62,27,60,60,61,62,27,44,
14,14,14,13,14,13,13,14,60,61,62,28,27,27,28,29,60,61,62,28,29,27,27,28,29,61,27,27,27,27,