26,27,28,26,26,26,26,28,27,28,28,28,28,28,61,61,61,61,61,61,61,61,61,28,61,61,61,61,61,28,
26,27,26,26,26,26,26,28,26,27,28,28,28,61,61,61,61,61,61,28,59,60,61,61,28,28,28,59,60,61,
26,26,26,28,26,26,28,26,27,28,28,26,26,26,61,61,61,28,28,28,28,59,60,61,61,28,27,28,28,59,
27,28,26,26,26,27,26,27,28,61,26,26,61,61,61,61,27,28,61,61,61,61,59,60,61,28,28,26,26,27,
27,28,60,26,26,27,26,61,61,26,26,59,61,61,28,28,59,28,26,27,26,26,27,28,26,26,26,26,27,28,
27,28,26,60,61,61,61,61,26,26,61,61,28,28,28,59,26,26,26,26,26,26,26,26,26,26,59,26,26,27,
27,26,26,60,61,61,28,28,26,61,27,28,28,61,59,59,26,26,26,59,26,26,26,26,60,26,26,26,26,27,
27,28,59,61,59,27,28,61,26,26,27,28,61,59,59,61,26,59,59,60,26,26,59,26,26,28,59,26,26,27,
27,28,27,61,59,59,59,26,26,28,28,61,26,59,59,26,59,59,60,61,26,59,60,61,28,61,59,59,26,27,
28,28,27,61,27,61,61,26,59,59,59,59,59,59,59,59,60,61,60,26,59,59,60,59,59,59,59,26,26,28,
28,61,28,61,27,61,26,27,26,61,59,26,59,26,59,59,60,61,26,26,59,59,59,28,61,26,59,26,27,28,
28,27,26,61,61,61,27,28,26,26,26,26,26,59,59,60,26,26,59,59,60,61,27,28,60,26,59,26,26,27,
28,26,27,61,61,26,27,28,61,26,26,26,26,59,59,26,59,59,59,60,26,27,59,28,28,27,59,59,26,27,
28,26,27,61,61,61,28,61,26,27,26,59,26,60,26,59,59,59,60,26,27,28,59,61,61,28,28,59,26,27,
28,26,27,61,61,61,61,61,26,26,59,26,26,26,59,59,26,59,26,27,28,26,27,59,60,61,61,59,26,27,
26,27,28,26,27,61,61,61,26,59,59,26,26,59,60,26,59,26,27,28,28,26,27,59,59,60,61,28,26,27,
27,28,26,27,28,61,27,61,61,26,26,26,59,60,61,26,59,26,27,28,61,26,26,26,26,27,28,26,28,27,
27,26,27,28,28,27,26,59,26,26,59,59,60,26,26,59,26,59,28,61,26,26,27,59,26,26,26,26,61,28,
27,26,27,28,61,59,26,26,26,59,59,60,61,26,59,60,26,27,59,59,59,26,27,28,26,26,26,26,61,61,
26,27,28,26,26,26,26,61,26,59,60,26,26,59,60,26,27,28,59,26,26,26,26,26,26,61,61,26,26,61,
26,27,28,26,26,59,60,26,59,60,61,59,26,59,26,26,26,26,26,26,61,61,61,59,59,61,61,61,26,61,
27,28,26,26,60,61,26,59,60,61,26,26,59,60,26,59,26,27,28,28,59,26,26,59,26,26,26,27,28,26,
26,26,59,60,61,26,59,59,60,26,26,59,60,26,27,59,59,26,27,28,26,26,26,59,59,26,27,28,28,26,
59,59,60,61,60,59,59,60,26,26,59,60,26,27,59,26,26,26,26,26,61,28,28,59,26,27,28,28,61,26,
59,60,26,26,26,59,60,26,26,59,26,26,26,26,26,26,26,59,26,59,27,28,61,59,27,28,28,61,60,26,
60,61,60,26,26,26,26,26,26,26,26,26,26,59,28,26,27,26,59,59,59,27,28,59,28,28,61,60,26,61,
59,59,59,59,59,59,59,59,59,60,61,26,59,27,26,26,26,59,26,26,59,59,59,59,28,28,26,26,26,60,
60,61,26,59,60,26,59,59,60,61,27,59,27,26,26,26,26,26,26,61,26,59,59,59,26,26,26,26,26,26,
60,61,26,59,26,59,59,60,59,59,59,59,26,26,59,26,59,60,61,26,27,26,27,59,59,59,59,59,59,59,
61,26,59,26,26,59,60,61,28,28,61,26,26,59,59,59,59,60,61,28,28,26,27,59,60,61,27,59,59,60,