27,27,27,27,27,27,27,27,60,60,60,60,60,60,60,60,60,60,60,60,27,27,27,27,27,27,28,29,29,60,
60,60,60,60,60,60,60,60,61,62,61,62,27,27,27,27,27,27,27,27,60,60,60,60,60,60,27,27,27,28,
62,60,60,61,62,29,29,29,29,29,29,29,29,29,29,29,29,29,27,28,29,29,29,29,29,29,60,60,27,28,
29,29,29,29,29,29,29,29,29,29,27,27,27,27,27,27,27,27,27,27,27,27,27,27,27,27,27,27,28,29,
62,27,27,27,27,27,27,27,27,27,27,27,27,27,27,27,60,60,60,60,60,60,60,60,60,60,60,60,27,27,
27,27,27,60,60,60,60,27,27,60,60,60,60,60,60,60,61,62,29,60,60,60,60,60,60,60,60,60,60,60,
60,60,60,61,27,27,27,60,60,61,62,62,62,62,62,62,62,62,27,27,27,27,27,27,27,27,27,27,27,28,
62,27,27,27,60,60,60,61,62,29,29,29,29,27,27,27,27,27,60,60,60,60,60,27,27,27,28,29,27,27,
27,60,60,60,61,62,62,62,27,27,27,27,27,60,60,60,60,60,61,27,27,27,27,60,60,27,28,29,29,27,
60,61,62,29,29,29,27,27,60,60,60,60,60,27,27,27,27,27,27,27,60,60,60,61,62,27,28,29,28,29,
61,62,62,27,27,27,60,60,61,62,27,27,27,60,60,27,27,60,60,60,61,62,60,60,27,28,29,29,28,29,
29,29,27,60,60,60,61,62,27,27,60,60,60,27,27,60,60,61,62,60,60,61,62,60,27,28,29,62,29,29,
27,27,60,61,62,27,27,27,60,60,61,62,27,60,60,61,62,62,62,62,62,27,28,27,28,29,62,29,29,62,
60,60,61,27,27,27,60,60,61,62,27,27,27,27,27,27,27,27,27,27,27,27,27,28,29,28,29,29,62,28,
27,27,27,60,60,60,61,27,27,27,27,27,60,27,27,27,27,27,27,27,27,60,60,27,27,27,27,27,28,29,
60,60,60,61,62,27,27,60,60,60,27,27,27,60,60,60,60,60,60,60,60,61,62,60,60,60,60,60,27,27,
60,61,27,27,27,60,60,27,27,27,60,60,60,61,62,62,29,29,27,28,60,27,28,29,29,60,27,28,60,60,
27,27,60,60,27,27,27,60,60,60,61,62,61,62,27,27,27,27,27,27,27,28,29,29,62,27,60,27,28,29,
60,60,27,27,60,60,60,61,62,60,60,61,62,60,60,60,60,60,60,60,60,27,27,27,27,27,28,27,28,29,
27,27,60,60,61,62,27,60,60,61,62,60,60,61,62,29,29,62,27,28,29,60,60,60,27,28,29,27,28,29,
60,60,61,62,27,27,60,61,62,62,27,28,29,29,27,27,27,27,27,27,27,27,27,27,27,27,27,27,27,28,
61,62,60,61,60,60,61,27,27,27,27,27,27,27,60,60,60,60,60,60,60,27,27,60,60,60,60,60,60,27,
62,62,29,27,27,27,27,60,60,60,60,60,60,60,61,27,27,27,27,27,27,27,27,27,27,27,27,28,29,60,
27,27,27,60,60,27,27,27,27,27,27,27,27,27,27,27,27,27,27,27,27,27,27,28,29,60,60,27,27,28,
60,60,60,27,27,60,27,28,29,29,29,60,60,60,60,60,60,60,60,60,60,60,60,27,27,27,28,29,27,28,
61,62,60,60,60,60,60,61,62,62,62,29,29,29,29,29,29,29,29,62,27,60,61,60,27,28,29,29,29,29,
29,29,29,60,61,62,62,62,62,60,61,62,62,62,62,62,62,62,62,29,29,29,29,29,29,29,29,62,62,62,
62,62,62,29,62,62,62,62,60,60,61,62,62,62,62,62,62,60,61,62,62,62,62,62,62,62,62,62,29,27,
29,29,29,29,29,29,29,29,60,61,62,29,29,29,62,62,62,62,60,61,60,61,62,62,62,29,29,29,29,29,
62,62,62,62,62,62,62,62,60,61,62,62,62,62,29,29,29,29,29,29,62,62,62,60,61,62,62,62,62,62,