26,27,26,27,28,29,26,27,28,29,29,62,62,62,26,27,118,118,29,62,26,26,27,28,29,26,59,60,61,62,
26,26,26,44,28,26,26,27,28,29,62,29,26,27,44,29,118,118,62,26,26,27,28,29,29,44,29,44,29,29,
26,59,26,27,28,26,27,44,29,44,26,27,28,29,29,44,118,118,39,39,39,39,39,29,62,29,62,62,62,62,
59,26,27,28,29,26,27,28,29,26,27,28,29,62,38,38,118,118,39,38,39,39,39,39,39,39,59,60,44,62,
44,26,27,28,44,26,27,28,29,28,29,29,38,39,38,38,118,118,39,38,39,39,38,39,39,39,39,60,44,44,
60,26,27,28,29,26,27,28,29,29,62,38,38,39,39,39,39,38,39,38,39,39,38,39,39,38,39,61,62,26,
26,27,44,29,44,26,44,28,29,62,38,38,39,39,39,39,38,39,39,39,38,39,38,39,39,38,39,62,26,27,
26,27,28,29,44,26,27,44,29,38,39,38,39,38,39,38,38,39,39,39,38,39,38,39,39,38,39,26,27,28,
26,27,28,29,60,26,27,28,38,39,38,39,39,38,39,39,38,39,39,38,38,38,39,39,39,38,39,27,28,29,
26,27,28,29,60,26,44,28,38,38,38,39,38,39,38,39,39,38,39,38,38,38,39,39,38,38,39,28,29,29,
27,44,29,62,60,26,27,38,39,38,39,39,39,39,38,39,39,38,38,39,38,38,39,39,38,39,27,28,29,62,
27,44,29,59,26,27,28,38,38,38,39,38,39,39,38,39,38,38,39,38,39,39,39,39,39,39,26,26,27,44,
27,28,44,59,26,27,38,39,38,38,39,39,39,38,38,39,38,38,39,38,39,39,39,38,39,39,39,27,28,29,
44,28,29,59,26,38,39,38,39,39,38,38,38,38,39,39,38,39,38,38,39,39,39,38,39,38,39,28,29,29,
28,29,44,60,38,39,38,39,39,39,39,38,38,39,39,39,38,39,38,38,39,39,39,38,39,38,39,29,62,62,
44,29,44,60,38,38,39,39,38,39,39,39,38,39,39,38,39,39,38,38,39,39,39,39,39,38,39,62,60,61,
28,29,59,44,38,38,39,38,39,39,39,38,39,38,39,38,39,38,38,38,39,39,39,39,39,38,39,39,44,59,
44,44,59,59,38,38,38,39,39,39,39,38,39,38,39,39,39,38,38,39,39,39,38,39,39,39,38,39,61,59,
28,29,59,59,38,38,38,39,38,39,39,39,38,39,39,39,38,38,38,39,39,38,38,39,38,39,38,39,29,29,
29,62,59,59,38,39,38,39,38,39,38,39,39,39,39,38,39,39,38,39,38,38,39,39,38,38,38,39,62,62,
29,26,59,26,38,39,38,39,39,39,39,38,39,39,39,39,39,39,39,39,38,38,39,38,39,38,39,60,61,62,
29,59,44,26,38,38,38,38,39,39,38,38,38,39,39,39,38,39,39,39,39,39,39,38,39,38,39,59,60,61,
29,59,59,26,27,38,38,39,39,39,39,38,39,38,39,38,38,39,39,38,39,39,38,38,38,38,39,60,59,60,
29,59,59,26,27,38,38,39,39,39,38,38,39,38,39,38,39,39,38,39,39,38,38,38,39,29,60,61,59,60,
29,44,59,26,27,38,38,38,39,38,38,38,38,38,38,38,39,39,39,39,38,38,39,38,39,62,61,26,59,44,
29,59,60,26,27,26,38,38,38,38,38,38,38,39,38,39,38,38,39,38,39,44,38,39,62,60,26,26,59,60,
26,59,60,26,27,26,26,27,28,29,26,59,38,38,38,38,38,38,38,38,38,38,39,29,61,44,59,59,59,60,
59,60,61,26,44,26,44,28,29,26,26,59,60,61,38,38,39,28,59,59,26,26,27,28,29,59,44,59,60,61,
59,60,61,26,26,26,27,28,29,44,59,59,60,61,62,26,27,28,44,27,59,59,26,26,26,27,28,29,60,61,
60,61,62,44,27,26,26,26,26,44,59,60,61,62,29,26,27,28,29,27,28,29,59,59,26,44,26,27,44,29,