29,29,29,29,29,29,29,29,29,29,29,29,29,29,29,29,29,60,60,60,60,27,27,27,27,27,27,27,27,27,
62,62,62,62,62,62,62,62,62,62,62,62,62,62,62,27,27,27,27,27,27,27,27,27,27,27,27,27,27,27,
27,27,27,27,27,27,27,27,27,27,27,27,27,27,27,60,60,60,60,60,60,60,60,60,60,60,60,60,27,28,
29,29,29,29,29,29,29,29,60,60,60,60,60,60,60,27,27,27,27,27,27,27,27,27,27,27,27,28,29,29,
27,27,27,27,27,27,27,27,27,28,29,27,27,27,27,60,60,60,60,60,60,60,60,60,60,60,60,27,44,27,
60,60,60,60,60,60,60,60,60,27,27,27,27,27,27,27,27,27,27,27,27,27,27,27,27,27,27,28,29,29,
27,27,27,27,27,27,27,27,28,29,27,27,27,27,27,27,27,27,27,27,28,27,27,27,27,28,28,27,27,27,
60,60,60,60,60,60,60,60,27,27,27,27,27,27,27,27,27,27,27,27,27,28,28,29,29,29,29,29,45,44,
62,62,62,62,62,62,62,62,60,60,60,60,60,60,60,60,60,60,60,60,27,27,27,27,28,29,29,29,44,29,
27,27,27,27,27,27,27,27,27,27,27,27,27,27,27,27,27,27,27,27,27,27,27,27,28,29,62,62,62,62,
60,60,60,60,60,60,60,60,60,60,60,60,60,60,60,60,60,60,60,60,60,60,60,60,27,27,27,27,27,27,
60,60,60,60,60,60,60,60,60,60,60,61,62,29,29,62,27,27,27,27,27,44,44,27,27,27,27,27,27,45,
27,27,27,27,27,27,27,27,27,27,27,27,27,27,27,27,60,60,60,60,27,28,27,27,27,27,27,44,45,45,
60,60,60,60,60,60,60,60,60,27,27,27,27,27,27,27,27,27,27,27,27,27,60,60,60,60,60,60,60,60,
27,27,27,27,27,27,27,27,27,27,60,60,60,60,60,60,60,60,60,60,60,60,27,27,27,27,27,27,27,27,
60,60,60,60,60,60,60,60,60,60,61,27,27,27,27,27,27,27,27,27,27,27,60,60,44,44,44,44,29,29,
62,29,27,27,27,27,27,27,27,27,27,60,60,60,60,60,60,60,60,27,28,29,29,29,29,29,29,29,62,44,
27,27,60,60,60,60,27,27,27,27,27,27,27,27,27,27,27,27,27,27,27,27,27,27,27,27,27,27,27,27,
27,27,27,27,27,27,27,27,27,27,27,27,27,27,27,27,27,27,27,27,27,27,27,27,27,44,27,27,27,44,
60,60,60,60,60,60,60,60,60,60,60,60,60,60,60,60,60,60,60,60,60,60,60,60,44,45,60,27,28,29,
60,27,27,27,27,27,27,27,27,27,27,27,27,27,27,27,27,27,27,27,27,27,27,27,27,27,27,27,27,27,
27,27,27,27,27,27,27,27,27,27,27,27,27,27,27,27,28,29,27,27,27,28,27,27,27,27,27,27,45,45,
27,60,60,60,60,60,60,60,60,27,27,27,28,29,60,60,27,27,27,27,27,27,27,28,29,27,27,27,44,45,
27,27,27,27,27,27,27,27,27,60,60,60,27,27,27,27,27,27,27,28,29,28,29,27,27,27,27,45,45,44,
60,60,60,60,60,60,60,60,60,61,62,60,60,60,27,27,27,27,27,27,27,27,27,27,28,29,27,28,29,29,
62,27,27,60,60,60,60,27,27,27,27,27,27,27,27,27,27,27,27,27,27,27,27,27,28,29,27,28,29,29,
27,27,27,27,27,27,27,27,27,60,60,60,60,60,60,60,60,60,60,60,60,60,60,60,27,27,27,28,29,29,
60,60,60,60,60,60,60,60,60,61,62,29,29,29,29,29,29,62,62,62,29,29,29,62,60,27,27,27,44,45,
61,62,29,29,29,29,29,29,62,62,62,62,62,62,62,62,62,29,62,62,62,62,62,62,62,27,60,60,27,28,
62,62,62,62,62,62,62,62,62,62,62,62,62,62,62,62,62,62,62,62,62,62,62,62,62,60,60,61,60,61,