27,28,29,29,62,62,29,26,26,26,26,27,28,29,29,29,29,29,29,29,29,26,27,28,29,29,26,27,28,29,
28,29,29,26,27,28,29,59,59,59,26,26,26,26,26,26,26,26,26,26,26,27,28,29,29,62,29,27,28,29,
28,29,26,27,28,29,26,27,28,29,59,59,59,59,59,59,59,26,27,28,29,29,28,29,62,62,62,27,28,29,
29,26,27,28,29,26,27,28,29,29,62,62,62,29,26,26,26,27,28,29,29,62,29,29,60,61,62,29,28,29,
26,27,28,29,26,27,28,29,62,62,60,61,26,26,59,26,27,28,29,29,62,62,62,62,29,60,61,62,28,29,
26,27,28,26,27,28,29,62,61,26,59,26,59,59,60,26,27,28,29,62,59,60,61,62,62,60,61,62,29,29,
27,28,26,27,28,29,62,60,61,59,26,59,59,60,26,27,26,27,28,29,26,27,28,29,29,29,61,62,62,29,
28,26,27,28,29,62,59,60,61,26,59,59,60,26,27,28,29,29,29,26,27,28,29,29,62,62,29,61,62,29,
26,27,28,29,29,26,59,60,26,59,59,60,26,27,28,29,29,62,62,26,27,28,29,62,62,29,62,61,62,29,
26,27,28,29,62,59,60,26,59,26,27,28,29,29,29,29,29,29,26,27,28,29,29,61,62,29,29,29,62,62,
27,28,29,29,59,59,26,26,27,28,29,29,62,62,62,62,62,62,29,29,28,29,62,62,62,62,62,29,61,62,
27,28,29,62,59,26,27,28,29,29,29,62,29,62,59,60,61,62,62,62,29,29,61,62,60,61,62,62,29,62,
27,28,29,59,26,27,28,29,29,62,62,29,29,26,27,28,59,60,61,62,62,29,62,28,59,60,61,62,62,62,
28,29,62,26,27,28,29,29,62,28,29,29,26,27,28,26,26,59,60,61,62,62,29,28,59,60,61,62,62,62,
28,29,59,26,27,28,29,62,27,28,29,26,27,28,26,59,59,26,59,60,61,62,62,29,59,60,61,62,62,29,
28,29,26,27,28,29,62,26,26,27,26,27,26,26,59,59,26,27,28,59,60,61,62,62,59,60,61,62,61,62,
27,26,26,27,28,29,60,59,26,26,26,26,59,59,60,61,26,27,28,29,59,60,61,62,60,61,62,60,61,62,
29,29,29,29,26,27,28,29,29,29,29,29,29,29,29,62,26,27,28,26,27,28,29,29,29,62,59,60,61,62,
29,26,27,28,29,29,29,62,62,62,62,62,62,62,62,26,109,110,27,28,29,29,29,29,29,29,29,29,29,62,
26,26,27,28,29,29,29,29,29,110,109,59,26,27,28,26,110,110,29,29,29,62,62,62,62,62,62,62,62,29,
26,27,28,29,29,62,62,62,62,59,110,110,26,26,26,110,110,28,29,62,62,61,59,60,61,59,60,61,62,62,
27,26,27,28,29,29,60,26,26,26,26,110,109,110,109,110,26,26,26,26,26,26,26,27,28,29,59,60,61,62,
27,28,29,26,26,26,26,59,59,26,27,28,29,29,109,59,59,59,26,27,28,29,29,29,29,62,27,59,60,61,
26,26,26,59,59,59,59,59,60,26,27,28,29,62,110,29,29,26,26,26,26,26,26,26,26,27,28,29,60,61,
59,59,59,59,60,61,26,27,28,29,27,28,29,62,109,62,62,29,29,29,29,29,59,59,26,27,28,26,27,28,
1,1,1,1,1,2,59,60,61,62,60,61,62,110,14,61,62,62,62,62,62,62,27,28,29,26,26,27,28,29,
0,1,2,3,1,1,1,1,1,1,1,1,110,14,1,1,1,1,1,1,2,59,60,61,62,28,29,28,29,62,
5,6,5,6,5,6,5,6,5,6,5,6,14,110,5,6,5,6,5,6,5,6,5,59,60,61,62,28,29,61,
13,13,13,13,13,14,13,13,13,13,14,13,13,13,13,13,13,13,13,13,13,13,13,14,26,26,27,28,29,61,
13,13,13,13,13,13,13,13,13,13,14,13,13,13,13,13,13,14,13,14,14,13,13,13,60,59,60,61,62,62,
