29,29,29,29,29,29,29,29,62,62,62,62,62,62,62,62,62,62,62,62,62,62,62,62,62,62,62,62,62,62,
27,27,27,27,27,28,29,29,29,29,29,29,29,29,29,29,29,29,27,27,27,27,27,27,27,27,27,60,61,62,
27,27,27,27,27,27,27,27,27,27,27,27,28,29,62,62,62,62,29,29,29,29,29,29,29,29,29,29,27,27,
60,60,60,60,60,60,60,60,60,60,60,60,27,27,27,27,27,27,27,27,28,29,27,27,27,27,27,27,27,27,
29,29,29,29,29,29,29,29,29,29,29,29,29,27,27,27,27,27,27,27,27,27,27,27,27,27,28,29,29,29,
27,27,27,27,27,27,27,27,27,27,27,27,27,27,27,27,27,27,27,27,27,27,27,27,27,27,27,27,28,29,
27,27,27,27,27,27,27,27,27,27,27,27,27,27,27,27,27,27,27,27,27,27,27,27,27,27,27,27,27,28,
27,27,27,27,27,27,27,27,27,27,27,27,27,27,27,27,27,27,27,28,29,27,27,27,27,27,27,28,29,29,
27,60,60,60,60,60,60,60,60,60,60,60,60,60,60,60,60,60,60,27,27,27,27,27,27,27,28,29,27,27,
60,60,61,62,27,27,27,27,27,27,27,27,27,27,27,27,27,27,27,27,27,27,27,27,27,27,27,28,29,27,
27,27,27,27,60,60,60,60,60,60,60,60,60,60,60,60,60,60,60,60,60,60,60,60,60,60,60,27,28,29,
27,27,27,27,27,27,27,27,27,27,27,27,28,29,27,27,27,27,27,27,27,27,28,29,62,62,62,27,28,29,
60,60,60,60,60,60,60,60,60,60,60,60,27,27,27,27,27,27,27,27,27,27,28,29,27,27,27,27,28,29,
60,61,62,29,60,60,61,62,60,60,60,60,60,60,60,60,60,60,60,60,60,60,27,27,27,27,27,28,29,29,
62,62,62,62,29,29,29,27,27,27,27,27,27,27,45,27,27,27,27,27,27,27,27,27,27,27,27,27,27,27,
29,27,27,27,27,27,27,60,60,60,44,44,44,45,60,60,60,60,60,60,60,60,60,60,60,60,60,60,60,60,
27,60,60,60,27,27,27,27,27,27,27,27,27,27,27,44,27,27,27,27,28,45,27,27,27,27,27,27,27,27,
27,27,27,27,27,27,27,27,60,60,60,60,60,60,60,60,60,60,60,60,27,27,45,45,27,27,28,29,27,28,
27,60,60,60,60,60,60,60,61,62,27,27,60,60,60,60,60,60,60,61,60,60,60,60,60,60,27,27,28,29,
60,61,62,29,27,27,27,60,60,60,60,60,61,62,62,62,27,28,29,29,62,62,27,28,29,29,60,27,28,29,
62,27,27,27,27,27,27,27,27,27,27,27,27,27,27,27,27,28,29,27,27,27,27,28,29,62,27,28,29,29,
27,27,27,27,60,60,60,60,60,60,60,60,60,60,60,60,60,27,27,27,27,27,27,27,27,27,27,27,28,29,
60,60,60,60,27,27,27,27,27,27,27,27,27,27,28,29,62,27,27,60,60,60,60,27,60,60,60,27,28,29,
27,27,27,27,27,27,27,27,27,27,27,27,27,27,27,27,27,60,60,61,62,27,27,27,28,29,62,27,28,29,
60,27,27,27,27,27,27,27,27,27,27,27,27,27,27,28,29,27,27,27,27,60,60,27,27,28,29,28,29,29,
27,60,60,60,60,60,60,60,60,60,27,27,60,60,60,61,62,60,60,60,60,61,62,27,28,29,29,29,29,62,
60,61,62,62,62,62,62,27,27,27,60,60,60,61,62,27,28,29,29,61,27,28,29,29,29,29,62,62,62,29,
62,62,62,62,62,27,27,60,60,60,60,61,62,27,28,29,29,29,29,29,29,29,62,62,62,62,62,29,29,29,
62,62,62,62,60,60,60,60,61,60,61,62,29,29,29,62,62,62,62,62,62,62,62,62,60,61,62,62,62,62,
29,29,29,62,62,60,61,62,62,60,61,62,62,62,62,60,61,62,29,62,60,61,62,62,62,62,62,62,62,62,