27,27,27,27,28,29,27,27,27,27,60,60,60,61,27,60,60,60,60,60,61,62,27,27,60,60,60,27,27,28,
60,60,60,60,27,27,28,29,60,60,61,27,27,27,60,61,62,60,60,27,28,29,60,60,60,60,60,60,27,28,
27,27,27,27,27,27,27,27,27,27,27,27,27,27,27,27,27,27,27,27,27,27,27,27,27,27,27,27,27,28,
27,60,60,27,27,27,27,27,27,27,27,60,60,60,60,60,60,60,60,60,60,38,60,60,60,60,60,60,60,27,
27,27,27,60,60,60,60,60,60,60,60,61,62,60,60,60,60,60,60,60,60,38,60,60,60,60,27,27,28,27,
60,60,60,61,62,60,60,60,61,62,62,27,28,60,27,28,29,62,60,60,60,38,28,29,29,29,27,28,27,28,
61,62,60,60,61,62,29,60,61,62,27,27,28,29,29,29,29,60,27,28,29,38,29,29,27,28,27,28,29,29,
60,60,61,62,29,29,29,29,29,29,29,27,27,27,27,27,27,27,27,27,27,27,27,27,27,27,27,28,29,62,
29,61,62,62,62,62,27,27,27,27,27,60,60,60,60,60,60,60,60,60,60,27,27,27,27,27,27,27,27,28,
62,29,27,27,27,27,60,60,60,60,60,61,62,29,29,27,27,27,27,27,27,60,60,60,60,60,60,60,27,27,
27,27,60,60,60,60,61,62,62,62,62,62,62,27,27,60,60,60,60,60,60,61,62,62,62,27,27,28,27,28,
60,60,61,62,60,61,62,27,28,27,27,27,27,27,27,27,27,27,27,27,28,29,62,27,28,27,28,29,27,28,
62,29,29,29,29,29,27,27,27,60,27,27,27,27,27,27,27,28,29,60,27,44,44,29,27,28,29,27,28,29,
62,62,62,62,27,27,60,60,27,27,27,27,60,60,60,60,27,27,28,29,44,44,29,62,27,28,27,28,29,62,
27,28,27,27,60,60,61,27,60,27,60,60,60,61,62,27,60,27,28,29,27,28,29,27,28,27,28,29,29,62,
27,28,60,60,61,27,44,60,27,60,60,61,62,29,60,27,28,27,28,29,28,29,62,29,27,27,27,27,27,27,
27,28,60,44,44,44,44,27,60,60,61,62,28,29,27,28,29,44,44,29,28,29,62,27,27,60,60,60,60,27,
27,28,29,60,60,61,27,27,60,61,62,27,28,44,27,28,29,27,28,29,28,27,27,27,27,27,28,29,29,27,
27,28,27,27,60,27,27,27,27,27,27,27,27,28,29,27,27,27,27,27,27,60,27,27,27,27,27,27,28,29,
27,28,60,27,27,60,60,60,60,60,60,27,27,27,27,60,60,60,60,27,60,27,27,60,60,60,60,27,27,28,
27,28,27,60,60,61,62,61,62,27,27,60,60,60,60,61,62,27,27,60,27,60,60,61,27,27,27,28,29,28,
27,28,60,60,61,62,60,27,27,60,60,61,62,29,60,27,28,27,60,27,60,60,45,27,60,60,27,28,29,27,
27,28,60,61,27,27,27,60,60,61,62,28,29,29,28,27,27,60,61,27,27,45,60,60,27,27,27,27,28,29,
27,27,60,27,60,60,60,61,62,29,27,28,29,62,29,27,60,27,27,60,60,60,27,60,60,60,60,27,27,28,
27,27,27,60,61,62,60,61,62,27,28,29,29,62,27,60,27,60,60,61,62,27,60,60,60,61,62,60,27,27,
27,60,60,61,62,62,29,61,62,27,28,29,62,27,60,27,60,60,61,62,62,60,60,61,60,61,62,28,60,27,
60,60,61,62,61,62,62,29,29,29,29,29,27,27,27,60,60,61,62,61,62,60,61,62,60,61,62,28,27,60,
60,61,62,61,62,60,61,62,62,29,27,28,29,60,60,60,61,62,61,62,27,60,61,62,60,61,62,29,60,60,
60,61,62,29,29,29,29,29,29,29,29,29,62,60,60,61,62,60,61,62,60,61,62,62,60,61,62,62,60,61,
27,60,61,62,62,62,62,62,62,62,62,62,62,60,60,61,62,29,29,62,61,60,61,62,62,60,61,62,60,61,