620,621,622,653,654,653,654,653,654,653,654,653,654,653,654,653,654,653,654,653,654,653,654,653,654,653,654,619,620,621,
653,654,655,803,804,805,806,807,808,809,1056,1057,1058,1059,1060,1056,1057,1058,1059,1060,803,804,805,806,807,808,809,652,653,654,
686,687,688,836,837,838,839,840,841,842,1089,1090,1091,1092,1093,1089,1090,1091,1092,1093,836,837,838,839,840,841,842,685,686,687,
622,720,721,869,870,871,872,873,874,875,1122,1123,1124,1125,1126,1122,1123,1124,1125,1126,869,870,871,872,873,874,875,718,719,619,
622,753,754,902,903,904,905,906,907,908,1155,1156,1157,1158,1159,1155,1156,1157,1158,1159,902,903,904,905,906,907,908,751,752,619,
622,786,787,935,936,937,938,939,940,941,1188,1189,1190,1191,1192,1188,1189,1190,1191,1192,935,936,937,938,939,940,941,784,785,619,
622,44,44,968,969,819,820,972,973,974,1221,1222,1223,1224,1225,1221,1222,1223,1224,1225,968,969,817,818,972,973,974,44,44,619,
622,44,44,1001,1002,1003,1004,1005,1006,1007,1254,1255,1256,1257,1258,1254,1255,1256,1257,1258,1001,1002,1003,1004,1005,1006,1007,44,44,619,
622,44,44,1034,1035,1036,1037,1038,1039,1040,1287,1288,1289,1290,1291,1287,1288,1289,1290,1291,1034,1035,1036,1037,1038,1039,1040,44,44,619,
655,916,916,916,916,361,361,916,916,916,916,916,361,916,916,916,916,361,916,916,916,916,361,361,883,883,884,883,884,619,
688,883,883,883,883,361,361,884,883,883,883,883,361,883,883,884,884,361,916,916,916,916,361,361,916,883,883,884,917,619,
721,916,916,916,916,361,361,917,916,916,916,916,361,916,916,917,917,361,883,883,883,883,361,361,883,883,883,884,884,619,
754,883,884,883,883,361,361,916,916,916,883,883,361,883,884,883,883,361,883,883,884,916,361,361,916,916,916,917,917,619,
787,916,917,916,916,361,361,916,916,916,916,916,361,916,917,916,916,361,916,916,917,916,361,361,916,916,917,883,884,619,
361,361,361,361,361,361,361,361,361,361,361,361,361,361,361,361,361,361,361,361,361,361,361,361,361,361,361,361,361,619,
361,361,361,361,361,361,361,361,361,361,361,361,361,361,361,361,361,361,361,361,361,361,361,361,361,361,361,361,361,619,
361,361,361,361,361,361,361,361,361,361,361,361,361,361,361,361,361,361,361,361,361,361,361,361,361,361,361,361,361,619,
589,883,883,1067,1068,1069,1070,1071,1072,1073,1074,883,883,883,361,361,361,883,883,883,883,759,760,761,762,763,764,765,884,619,
622,916,916,1100,1101,1102,1103,1104,1105,1106,1107,916,916,916,361,361,361,916,916,916,916,792,793,794,795,796,797,798,917,619,
622,883,883,1133,1134,1135,1136,1137,1138,1139,1140,883,883,883,361,361,361,883,883,883,883,825,826,827,828,829,830,831,884,619,
622,916,916,1166,1167,1168,1169,1170,1171,1172,1173,916,916,916,361,361,361,916,916,916,916,858,859,860,861,862,863,864,917,619,
622,883,883,1199,1200,1201,1202,1203,1204,1205,1206,883,883,883,361,361,361,884,883,883,883,891,892,893,894,895,896,897,884,619,
622,916,916,1232,1233,1234,1235,1236,1237,1238,1239,916,916,916,361,361,361,917,916,916,916,924,925,926,927,928,929,930,917,619,
622,883,883,1265,1266,1267,1268,1269,1270,1271,1272,883,883,883,361,361,361,883,883,883,883,957,958,959,960,961,962,963,851,619,
622,916,916,1298,1299,1300,1301,1302,1303,1304,1305,361,361,361,361,361,361,361,361,361,361,990,991,992,993,994,995,996,884,619,
622,883,883,361,361,361,361,361,361,361,361,361,361,361,361,361,361,361,361,361,361,361,361,361,361,361,361,361,917,619,
622,916,916,361,361,361,361,361,361,361,361,361,361,361,361,361,361,361,361,361,361,361,361,361,361,361,361,361,884,619,
622,851,851,883,883,883,883,883,883,883,884,883,883,883,916,917,883,883,883,883,884,883,883,883,883,883,884,916,917,619,
587,588,589,916,916,916,916,916,916,916,917,916,916,916,916,916,916,916,916,916,917,916,916,916,916,916,917,586,587,588,
620,621,622,588,587,588,587,588,587,588,587,588,587,588,587,588,587,588,587,588,587,588,587,588,587,588,587,619,620,621,
